Timestamp,ACC (BIRD),ACC (EDYY),ACC (EGGX),ACC (EGTT),ACC (EHAA),ACC (EISN),ACC (EKDK),ACC (ENOS),Total
18:28:19.084,0,0,0,0,0,0,0,0,0
18:33:19.087,0,0,0,0,0,0,0,0,0
18:38:19.090,0,4,0,6,0,0,0,0,10
18:43:19.092,0,14,0,16,0,0,0,0,30
18:48:19.093,2,22,6,22,0,0,4,0,56
18:53:19.095,4,28,12,28,0,0,4,0,76
18:58:19.097,6,38,12,32,0,0,4,4,96
19:03:19.099,22,40,12,44,0,0,8,8,134
19:08:19.101,26,40,16,54,0,0,8,10,154
19:13:19.102,26,48,20,68,0,0,8,12,182
19:18:19.104,30,56,24,74,0,0,8,12,204
19:23:19.107,34,60,29,84,0,0,14,12,233
19:28:19.109,36,62,29,106,0,0,24,12,269
19:33:19.111,36,64,30,130,0,2,28,12,302
19:38:19.112,40,76,45,138,0,2,34,12,347
19:43:19.149,42,90,46,154,0,5,38,16,391
19:48:19.117,60,92,50,162,0,8,44,20,436
19:53:19.119,62,92,55,178,0,9,44,22,462
19:58:19.121,62,102,63,190,0,11,44,24,496
20:03:19.123,66,110,71,198,0,12,44,24,525
20:08:19.125,70,118,74,208,0,12,52,24,558
20:13:19.126,72,122,78,230,0,12,60,24,598
20:18:19.128,72,124,82,252,0,12,62,24,628
20:23:19.130,76,134,95,262,0,14,70,24,675
20:28:19.166,76,146,98,277,0,15,74,28,714
20:33:19.168,96,154,108,285,0,18,80,34,775
20:38:19.135,98,156,115,301,0,21,80,34,805
20:43:19.136,98,166,123,313,0,23,80,36,839
20:48:19.137,102,174,129,321,0,24,80,36,866
20:53:19.173,108,182,132,337,0,24,88,36,907
20:58:19.142,108,186,136,351,0,24,96,36,937
21:03:19.144,108,188,140,376,0,25,100,36,973
21:08:19.146,112,198,155,381,0,26,106,36,1014
21:13:19.148,112,212,156,399,0,27,110,40,1056
21:18:19.186,130,218,164,408,0,31,116,46,1113
21:23:19.153,134,220,171,422,0,33,116,46,1142
21:28:19.154,134,228,179,436,0,35,116,48,1176
21:33:19.156,138,238,187,444,0,36,116,48,1207
21:38:19.159,138,244,190,454,0,36,122,48,1232
21:43:19.159,144,248,194,476,0,36,132,48,1278
21:48:19.162,144,252,197,497,0,37,134,48,1309
21:53:19.164,146,258,209,506,0,38,140,48,1345
21:58:19.166,148,272,214,516,0,40,146,52,1388
22:03:19.168,160,282,222,529,0,43,150,54,1440
22:08:19.204,170,284,227,543,0,45,152,58,1479
22:13:19.204,170,288,237,549,0,47,152,60,1503
22:18:19.173,174,302,243,567,0,48,152,60,1546
22:23:19.176,174,306,248,573,0,48,156,60,1565
22:28:19.213,180,310,252,589,0,48,168,60,1607
22:33:19.215,180,316,255,611,0,48,168,60,1638
22:38:19.182,182,320,261,623,0,50,176,60,1672
22:43:19.184,184,328,272,637,0,50,180,64,1715
22:48:19.185,188,346,280,648,0,54,184,64,1764
22:53:19.223,202,348,285,662,0,56,188,70,1811
22:58:19.189,206,348,293,672,0,58,188,72,1837
23:03:19.191,208,364,301,688,0,60,188,72,1881
23:08:19.193,210,368,305,694,0,60,192,72,1901
23:13:19.194,216,374,310,704,0,60,200,72,1936
23:18:19.231,216,380,312,726,0,60,204,72,1970
23:23:19.199,216,380,315,746,0,62,210,72,2001
23:28:19.201,220,392,329,758,0,62,216,72,2049
23:33:19.203,222,408,335,769,0,66,220,78,2098
23:38:19.205,236,410,343,775,0,68,222,78,2132
23:43:19.206,242,412,346,793,0,69,224,84,2170
23:48:19.208,244,422,357,807,0,72,224,84,2210
23:53:19.211,246,430,363,813,0,72,228,84,2236
23:58:19.212,252,438,366,823,0,72,232,84,2267
00:03:19.215,252,442,370,843,0,72,240,84,2303
00:08:19.216,252,444,372,866,0,74,242,84,2334
00:13:19.218,254,456,385,877,0,74,250,84,2380
00:18:19.254,256,464,389,889,0,75,254,88,2415
00:23:19.222,266,474,398,898,0,80,256,90,2462
00:28:19.227,276,476,401,914,0,80,260,96,2503
00:33:19.226,280,482,413,928,0,82,260,96,2541
00:38:19.262,282,494,417,936,0,84,264,96,2573
00:43:19.264,284,502,422,946,0,84,268,96,2602
00:48:19.233,288,504,426,962,0,84,276,96,2636
00:53:19.235,288,508,430,986,0,84,278,96,2670
00:58:19.274,290,514,439,992,0,86,284,96,2701
01:03:19.238,292,522,447,1006,0,86,288,100,2741
01:08:19.239,296,538,456,1017,0,91,292,102,2792
01:13:19.241,310,540,459,1035,0,92,294,104,2834
01:18:19.243,316,544,471,1041,0,94,296,108,2870
01:23:19.245,316,558,475,1059,0,96,300,108,2912
01:28:19.281,320,562,479,1067,0,96,304,108,2936
01:33:19.249,324,566,484,1077,0,96,308,108,2963
01:38:19.287,324,572,487,1101,0,96,312,108,3000
01:43:19.253,326,574,489,1115,0,98,318,108,3028
01:48:19.256,328,584,505,1129,0,98,324,108,3076
01:53:19.257,330,598,512,1139,0,102,328,114,3123
01:58:19.259,340,604,517,1155,0,104,328,116,3164
02:03:19.296,350,606,526,1163,0,105,332,120,3202
02:08:19.263,352,618,533,1179,0,108,336,120,3246
02:13:19.264,356,622,537,1189,0,108,338,120,3270
02:18:19.300,360,630,540,1197,0,108,342,120,3297
02:23:19.268,360,636,544,1219,0,109,348,120,3336
02:28:19.270,360,636,547,1239,0,110,354,120,3366
02:33:19.306,364,648,562,1247,0,111,358,120,3410
02:38:19.274,364,652,567,1258,0,112,364,126,3443
02:43:19.276,370,666,575,1276,0,116,364,128,3495
02:48:19.313,382,668,580,1282,0,117,368,128,3525
02:53:19.313,388,680,587,1298,0,119,370,132,3574
02:58:19.281,390,686,595,1310,0,121,374,132,3608
03:03:19.318,396,694,597,1318,0,121,376,132,3634
03:08:19.285,396,698,601,1332,0,121,382,132,3662
03:13:19.320,396,700,604,1358,0,122,386,132,3698
03:18:19.288,398,708,614,1368,0,123,394,132,3737
03:23:19.323,400,716,623,1381,0,124,398,134,3776
03:28:19.324,402,726,630,1394,0,127,400,140,3819
03:33:19.293,416,732,637,1406,0,129,402,140,3862
03:38:19.327,424,740,643,1412,0,129,406,144,3898
03:43:19.330,426,750,649,1434,0,132,410,144,3945
03:48:19.297,428,754,653,1442,0,133,412,144,3966
03:53:19.333,432,760,658,1450,0,133,416,144,3993
03:58:19.302,432,764,662,1474,0,133,420,144,4029
04:03:19.303,434,770,668,1488,0,135,428,144,4067
04:08:19.343,436,778,679,1498,0,135,432,146,4104
04:13:19.307,438,784,688,1513,0,137,436,152,4148
04:18:19.344,442,796,695,1527,0,141,436,152,4189
04:23:19.311,456,802,701,1535,0,141,442,156,4233
04:28:19.313,462,814,707,1555,0,143,446,156,4283
04:33:19.314,462,816,711,1563,0,145,448,156,4301
04:38:19.317,468,822,716,1569,0,145,450,156,4326
04:43:19.318,468,828,719,1593,0,145,454,156,4363
04:48:19.320,468,828,722,1609,0,146,462,156,4391
04:53:19.356,472,840,732,1619,0,147,468,158,4436
04:58:19.323,474,846,744,1634,0,148,472,162,4480
05:03:19.358,476,856,753,1646,0,152,472,164,4519
05:08:19.361,488,866,756,1654,0,153,476,164,4557
05:13:19.363,496,878,763,1662,0,155,482,168,4604
05:18:19.330,498,878,769,1682,0,157,484,168,4636
05:23:19.332,504,886,771,1690,0,157,484,168,4660
05:28:19.334,504,890,777,1708,0,157,490,168,4694
05:33:19.336,504,892,779,1729,0,158,496,168,4726
05:38:19.338,506,902,786,1736,0,159,502,170,4761
05:43:19.339,508,910,801,1752,0,160,506,170,4807
05:48:19.341,512,912,808,1765,0,162,508,176,4843
05:53:19.343,516,930,813,1777,0,165,508,176,4885
05:58:19.346,530,940,819,1781,0,165,516,180,4931
06:03:19.348,534,942,823,1803,0,167,520,180,4969
06:08:19.349,534,948,827,1811,0,169,520,180,4989
06:13:19.385,540,950,835,1825,0,169,524,180,5023
06:18:19.354,540,956,837,1841,0,169,528,180,5051
06:23:19.355,542,962,840,1855,0,170,536,182,5087
06:28:19.357,544,972,855,1869,0,171,540,182,5133
06:33:19.358,546,974,866,1882,0,173,544,188,5173
06:38:19.361,550,988,871,1898,0,176,544,188,5215
06:43:19.363,562,1002,875,1902,0,177,550,188,5256
06:48:19.364,570,1006,881,1920,0,179,556,192,5304
06:53:19.366,570,1010,885,1932,0,181,556,192,5326
06:58:19.368,576,1014,891,1942,0,181,558,192,5354
07:03:19.371,576,1020,893,1962,0,181,560,192,5384
07:08:19.373,576,1020,896,1977,0,182,570,194,5415
07:13:19.375,580,1032,906,1990,0,183,576,194,5461
07:18:19.376,582,1036,920,2003,0,184,580,196,5501
07:23:19.411,586,1048,929,2019,0,186,580,200,5548
07:28:19.414,590,1066,930,2025,0,189,584,200,5584
07:33:19.415,602,1070,937,2039,0,189,592,204,5633
07:38:19.384,606,1070,943,2049,0,191,592,204,5655
07:43:19.386,612,1076,946,2061,0,193,592,204,5684
07:48:19.389,612,1080,951,2077,0,193,596,204,5713
07:53:19.391,612,1084,954,2096,0,194,604,204,5748
07:58:19.392,614,1092,958,2105,0,194,610,206,5779
08:03:19.395,616,1100,977,2121,0,196,614,208,5832
08:08:19.396,622,1106,986,2134,0,197,616,212,5873
08:13:19.399,622,1130,987,2148,0,200,620,212,5919
08:18:19.434,636,1134,993,2154,0,201,626,212,5956
08:23:19.403,642,1134,999,2166,0,203,628,216,5988
08:28:19.405,646,1140,1002,2184,0,205,628,216,6021
08:33:19.407,648,1142,1008,2192,0,205,632,216,6043
08:38:19.409,648,1148,1011,2208,0,206,636,216,6073
08:43:19.412,650,1150,1014,2228,0,206,644,218,6110
08:48:19.447,652,1158,1023,2242,0,208,648,218,6149
08:53:19.416,654,1166,1042,2247,0,208,652,220,6189
08:58:19.419,658,1180,1045,2267,0,212,654,224,6240
09:03:19.420,660,1198,1051,2273,0,213,658,224,6277
09:08:19.422,676,1198,1053,2283,0,214,664,228,6316
09:13:19.424,678,1202,1059,2295,0,217,664,228,6343
09:18:19.458,682,1206,1066,2313,0,217,666,228,6378
09:23:19.464,684,1212,1068,2323,0,217,668,228,6400
09:28:19.465,684,1214,1069,2339,0,218,676,230,6430
09:33:19.433,688,1218,1079,2357,0,218,684,230,6474
09:38:19.436,690,1226,1091,2369,0,220,688,232,6516
09:43:19.438,694,1238,1101,2382,0,221,690,232,6558
09:48:19.477,694,1258,1108,2394,0,224,694,236,6608
09:53:19.442,710,1262,1109,2404,0,225,698,236,6644
09:58:19.443,714,1264,1117,2410,0,227,700,240,6672
10:03:19.446,718,1268,1122,2432,0,229,700,240,6709
10:08:19.447,720,1272,1125,2442,0,229,704,240,6732
10:13:19.450,720,1276,1127,2454,0,230,708,242,6757
10:18:19.452,722,1278,1135,2475,0,230,716,242,6798
10:23:19.454,724,1288,1145,2490,0,232,722,244,6845
10:28:19.492,728,1298,1158,2504,0,233,724,244,6889
10:33:19.492,730,1316,1165,2516,0,233,728,248,6936
10:38:19.460,736,1326,1167,2528,0,237,732,248,6974
10:43:19.462,750,1326,1171,2530,0,237,736,252,7002
10:48:19.464,750,1332,1178,2554,0,239,736,252,7041
10:53:19.465,756,1332,1183,2566,0,241,740,252,7070
10:58:19.467,756,1338,1185,2576,0,242,744,254,7095
11:03:19.504,758,1342,1192,2590,0,242,748,254,7126
11:08:19.471,760,1348,1197,2608,0,243,756,256,7168
11:13:19.472,764,1362,1214,2619,0,245,760,256,7220
11:18:19.474,766,1378,1221,2633,0,245,764,256,7263
11:23:19.477,770,1390,1225,2651,0,248,768,260,7312
11:28:19.479,782,1390,1229,2651,0,249,772,260,7333
11:33:19.480,786,1394,1236,2667,0,251,772,264,7370
11:38:19.515,790,1396,1240,2683,0,253,774,264,7400
11:43:19.520,792,1402,1242,2689,0,253,780,266,7424
11:48:19.486,792,1406,1250,2713,0,254,782,266,7463
11:53:19.489,794,1406,1255,2728,0,254,790,268,7495
11:58:19.491,800,1420,1266,2741,0,256,796,268,7547
12:03:19.492,802,1438,1279,2752,0,257,800,268,7596
12:08:19.494,804,1450,1281,2770,0,258,804,272,7639
12:13:19.526,810,1454,1287,2774,0,261,804,272,7662
12:18:19.499,822,1458,1292,2784,0,261,808,276,7701
12:23:19.501,826,1460,1295,2802,0,263,810,276,7732
12:28:19.502,828,1464,1300,2812,0,265,816,278,7763
12:33:19.504,828,1468,1308,2828,0,266,816,278,7792
12:38:19.539,830,1470,1313,2846,0,266,824,280,7829
12:43:19.544,836,1480,1320,2860,0,267,832,280,7875
12:48:19.511,836,1500,1335,2867,0,269,836,280,7923
12:53:19.514,840,1508,1339,2893,0,269,840,284,7973
12:58:19.564,842,1518,1345,2897,0,272,840,284,7998
13:03:19.550,854,1522,1349,2907,0,273,844,284,8033
13:08:19.520,862,1524,1352,2919,0,275,844,288,8064
13:13:19.554,862,1526,1358,2935,0,277,852,288,8098
13:18:19.523,864,1532,1364,2951,0,278,852,288,8129
13:23:19.547,866,1544,1378,2961,0,278,862,288,8177
13:28:19.536,868,1554,1384,2975,0,279,866,292,8218
13:33:19.552,886,1564,1388,2985,0,281,872,296,8272
13:38:19.590,890,1564,1391,3002,0,281,872,298,8298
13:43:19.554,890,1572,1401,3014,0,283,872,300,8332
13:48:19.603,894,1584,1403,3022,0,285,872,300,8360
13:53:19.587,894,1588,1410,3032,0,286,878,300,8388
13:58:19.646,900,1590,1415,3052,0,289,888,300,8434
14:03:19.674,900,1596,1415,3074,0,290,890,300,8465
14:08:19.622,902,1602,1431,3084,0,291,896,300,8506
14:13:19.590,904,1618,1438,3094,0,292,902,304,8552
14:18:19.592,918,1628,1440,3107,0,296,906,308,8603
14:23:19.649,926,1628,1447,3121,0,298,908,310,8638
14:28:19.691,926,1632,1455,3127,0,300,908,310,8658
14:33:19.624,930,1646,1461,3145,0,301,908,312,8703
14:38:19.693,930,1650,1466,3153,0,301,912,312,8724
14:43:19.697,936,1656,1470,3165,0,301,920,312,8760
14:48:19.658,936,1660,1472,3189,0,301,924,312,8794
14:53:19.657,938,1664,1479,3203,0,303,930,312,8829
14:58:19.710,940,1672,1490,3215,0,304,936,316,8873
15:03:19.753,948,1690,1496,3226,0,307,940,316,8923
15:08:19.684,960,1692,1503,3240,0,310,944,322,8971
15:13:19.714,962,1692,1511,3248,0,312,944,322,8991
15:18:19.697,962,1708,1519,3266,0,313,944,324,9036
15:23:19.740,966,1712,1523,3270,0,313,946,324,9054
15:28:19.745,972,1718,1528,3288,0,313,954,324,9097
15:33:19.720,972,1724,1530,3306,0,313,960,324,9129
15:38:19.751,974,1726,1533,3318,0,315,964,326,9156
15:43:19.756,976,1730,1535,3338,0,315,968,326,9188
15:48:19.698,978,1732,1543,3355,0,318,972,328,9226
15:53:19.776,984,1746,1555,3357,0,321,980,328,9271
15:58:19.759,984,1764,1564,3361,0,322,984,328,9307
16:03:19.804,988,1764,1572,3383,0,325,988,332,9352
16:08:19.814,988,1778,1580,3389,0,325,988,332,9380
16:13:19.796,1002,1784,1583,3397,0,325,990,332,9413
16:18:19.787,1010,1788,1588,3409,0,325,994,336,9450
16:23:19.793,1010,1788,1593,3425,0,326,1000,338,9480
16:28:19.789,1012,1792,1596,3437,0,327,1000,338,9502
16:33:19.912,1014,1792,1605,3455,0,328,1006,340,9540
16:38:19.820,1018,1800,1611,3471,0,329,1012,340,9581
16:43:19.886,1020,1822,1621,3479,0,332,1020,340,9634
16:48:19.603,1024,1830,1630,3500,0,332,1024,340,9680
16:53:19.606,1024,1838,1637,3510,0,334,1024,344,9711
16:58:19.609,1030,1846,1641,3520,0,336,1024,344,9741
17:03:19.611,1046,1848,1643,3526,0,337,1028,348,9776
17:08:19.613,1046,1848,1649,3544,0,340,1036,350,9813
17:13:19.615,1048,1856,1658,3558,0,340,1036,350,9846
17:18:19.616,1050,1856,1661,3572,0,341,1040,352,9872
17:23:19.619,1052,1862,1669,3587,0,342,1044,352,9908
17:28:19.620,1056,1882,1675,3602,0,344,1056,352,9967
17:33:19.622,1058,1892,1688,3617,0,345,1060,352,10012
17:38:19.624,1060,1894,1694,3629,0,346,1060,356,10039
17:43:19.626,1062,1910,1698,3643,0,349,1060,356,10078
17:48:19.629,1074,1912,1702,3649,0,349,1062,356,10104
17:53:19.630,1082,1912,1705,3665,0,351,1072,360,10147
17:58:19.633,1082,1914,1712,3679,0,353,1072,362,10174
18:03:19.635,1084,1920,1718,3689,0,354,1076,364,10205
18:08:19.637,1088,1926,1726,3703,0,354,1078,364,10239
18:13:19.639,1090,1940,1733,3723,0,355,1090,364,10295
18:18:19.641,1094,1954,1740,3735,0,357,1096,364,10340
18:23:19.643,1096,1956,1750,3748,0,357,1096,364,10367
18:28:19.645,1096,1970,1754,3764,0,359,1096,368,10407
18:33:19.648,1104,1976,1759,3770,0,362,1098,368,10437
18:38:19.649,1116,1976,1761,3776,0,362,1108,372,10471
18:43:19.652,1118,1978,1768,3796,0,365,1108,374,10507
18:48:19.654,1120,1984,1774,3808,0,366,1112,376,10540
18:53:19.656,1122,1986,1784,3824,0,367,1112,376,10571
18:58:19.660,1124,2002,1787,3843,0,367,1120,376,10619
19:03:19.661,1130,2014,1796,3858,0,369,1132,376,10675
19:08:19.662,1130,2020,1808,3869,0,370,1132,376,10705
19:13:19.663,1132,2028,1812,3881,0,371,1132,380,10736
19:18:19.701,1134,2040,1817,3893,0,374,1132,380,10770
19:23:19.668,1150,2040,1819,3899,0,374,1142,384,10808
19:28:19.670,1154,2042,1825,3913,0,376,1144,386,10840
19:33:19.672,1154,2046,1832,3937,0,378,1146,386,10879
19:38:19.674,1160,2050,1841,3945,0,379,1148,388,10911
19:43:19.676,1162,2066,1843,3965,0,379,1156,388,10959
19:48:19.678,1166,2078,1856,3977,0,380,1166,388,11011
19:53:19.680,1168,2084,1864,3994,0,382,1168,388,11048
19:58:19.717,1168,2094,1870,4006,0,382,1168,392,11080
20:03:19.685,1174,2104,1875,4016,0,385,1170,392,11116
20:08:19.723,1190,2104,1876,4026,0,386,1178,396,11156
20:13:19.689,1190,2106,1883,4036,0,388,1180,398,11181
20:18:19.691,1192,2110,1890,4056,0,390,1182,400,11220
20:23:19.693,1196,2112,1895,4064,0,391,1184,400,11242
20:28:19.695,1196,2126,1901,4086,0,391,1192,400,11292
20:33:19.696,1202,2140,1916,4102,0,393,1202,400,11355
20:38:19.731,1202,2148,1922,4111,0,394,1204,404,11385
20:43:19.700,1204,2162,1927,4131,0,394,1204,404,11426
20:48:19.702,1212,2168,1933,4139,0,398,1204,404,11458
20:53:19.704,1226,2168,1935,4149,0,398,1216,408,11500
20:58:19.707,1226,2170,1940,4163,0,400,1216,410,11525
21:03:19.708,1228,2174,1948,4179,0,402,1220,412,11563
21:08:19.711,1232,2178,1956,4191,0,403,1220,412,11592
21:13:19.713,1232,2188,1960,4212,0,403,1228,412,11635
21:18:19.715,1238,2206,1970,4221,0,405,1238,412,11690
21:23:19.751,1240,2214,1982,4236,0,406,1240,412,11730
21:28:19.719,1240,2222,1984,4248,0,407,1240,416,11757
21:33:19.754,1242,2232,1991,4262,0,410,1240,416,11793
21:38:19.723,1260,2232,1993,4266,0,410,1248,416,11825
21:43:19.758,1262,2232,1999,4280,0,412,1252,422,11859
21:48:19.726,1264,2236,2006,4300,0,414,1254,422,11896
21:53:19.728,1266,2240,2013,4310,0,415,1256,424,11924
21:58:19.730,1268,2250,2016,4332,0,415,1260,424,11965
22:03:19.731,1272,2268,2023,4342,0,416,1274,424,12019
22:08:19.734,1274,2276,2036,4359,0,418,1276,424,12063
22:13:19.735,1276,2282,2040,4363,0,418,1276,428,12083
22:18:19.772,1278,2296,2047,4385,0,421,1276,428,12131
22:23:19.740,1292,2296,2051,4387,0,422,1280,428,12156
22:28:19.776,1298,2296,2053,4399,0,423,1288,434,12191
22:33:19.742,1298,2300,2064,4419,0,426,1288,434,12229
22:38:19.743,1300,2304,2068,4429,0,427,1292,436,12256
22:43:19.747,1304,2312,2074,4451,0,427,1294,436,12298
22:48:19.781,1306,2324,2081,4461,0,427,1308,436,12343
22:53:19.783,1310,2338,2090,4475,0,430,1312,436,12391
22:58:19.786,1312,2344,2098,4487,0,430,1312,440,12423
23:03:19.753,1312,2356,2105,4505,0,433,1312,440,12463
23:08:19.755,1324,2360,2108,4509,0,434,1314,440,12489
23:13:19.792,1334,2360,2111,4521,0,436,1324,444,12530
23:18:19.760,1334,2362,2120,4541,0,438,1324,446,12565
23:23:19.763,1336,2368,2124,4551,0,438,1328,448,12593
23:28:19.764,1340,2374,2132,4567,0,439,1328,448,12628
23:33:19.766,1340,2386,2137,4583,0,439,1340,448,12673
23:38:19.769,1346,2400,2144,4595,0,441,1348,448,12722
23:43:19.806,1346,2404,2156,4608,0,442,1348,448,12752
23:48:19.773,1348,2416,2162,4624,0,443,1348,452,12793
23:53:19.775,1354,2424,2165,4632,0,446,1348,452,12821
23:58:19.777,1368,2424,2167,4638,0,446,1358,456,12857
00:03:19.780,1370,2426,2177,4652,0,448,1360,458,12891
00:08:19.781,1372,2430,2180,4670,0,450,1362,460,12924
00:13:19.782,1376,2434,2189,4680,0,451,1364,460,12954
00:18:19.784,1376,2446,2191,4702,0,451,1372,460,12998
00:23:19.786,1382,2462,2202,4712,0,453,1382,460,13053
00:28:19.820,1382,2468,2212,4729,0,454,1384,460,13089
00:33:19.788,1384,2474,2217,4742,0,455,1384,464,13120
00:38:19.790,1384,2488,2223,4756,0,458,1384,464,13157
00:43:19.827,1404,2488,2225,4760,0,458,1392,464,13191
00:48:19.829,1406,2490,2229,4774,0,460,1396,470,13225
00:53:19.797,1408,2492,2238,4792,0,462,1396,470,13258
00:58:19.798,1410,2496,2245,4800,0,463,1400,472,13286
01:03:19.801,1412,2506,2248,4822,0,463,1402,472,13325
01:08:19.801,1416,2524,2256,4834,0,465,1418,472,13385
01:13:19.803,1418,2532,2268,4846,0,466,1420,472,13422
01:18:19.807,1420,2536,2272,4857,0,466,1420,476,13447
01:23:19.807,1420,2552,2281,4877,0,469,1420,476,13495
01:28:19.809,1436,2552,2282,4881,0,470,1422,476,13519
01:33:19.812,1442,2552,2285,4891,0,472,1432,482,13556
01:38:19.814,1442,2554,2296,4909,0,475,1432,482,13590
01:43:19.817,1444,2560,2300,4921,0,475,1436,484,13620
01:48:19.819,1448,2566,2306,4937,0,476,1438,484,13655
01:53:19.820,1450,2578,2313,4954,0,476,1450,484,13705
01:58:19.858,1454,2594,2320,4967,0,478,1456,484,13753
02:03:19.828,1456,2600,2330,4979,0,479,1456,488,13788
02:08:19.862,1456,2612,2337,4997,0,481,1456,488,13827
02:13:19.829,1468,2616,2339,5003,0,483,1458,488,13855
02:18:19.832,1478,2616,2341,5015,0,483,1468,492,13893
02:23:19.834,1478,2618,2354,5029,0,485,1468,494,13926
02:28:19.835,1480,2624,2354,5043,0,487,1470,496,13954
02:33:19.837,1484,2630,2364,5059,0,488,1472,496,13993
02:38:19.839,1484,2640,2369,5077,0,488,1482,496,14036
02:43:19.876,1490,2652,2376,5089,0,490,1492,496,14085
02:48:19.875,1490,2660,2388,5100,0,491,1492,496,14117
02:53:19.843,1492,2670,2392,5118,0,492,1492,500,14156
02:58:19.845,1494,2680,2397,5126,0,495,1492,500,14184
03:03:19.848,1512,2680,2399,5136,0,495,1502,504,14228
03:08:19.850,1514,2682,2405,5144,0,497,1504,506,14252
03:13:19.852,1516,2686,2412,5162,0,499,1506,506,14287
03:18:19.889,1520,2688,2419,5172,0,500,1508,508,14315
03:23:19.856,1520,2700,2422,5196,0,500,1514,508,14360
03:28:19.858,1526,2718,2432,5206,0,501,1526,508,14417
03:33:19.861,1526,2724,2444,5223,0,503,1528,508,14456
03:38:19.863,1528,2730,2446,5231,0,503,1528,512,14478
03:43:19.864,1528,2744,2455,5249,0,506,1528,512,14522
03:48:19.903,1546,2744,2457,5253,0,507,1532,512,14551
03:53:19.903,1550,2744,2459,5267,0,509,1540,518,14587
03:58:19.904,1550,2748,2470,5283,0,511,1540,518,14620
04:03:19.873,1552,2752,2476,5293,0,512,1544,520,14649
04:08:19.875,1556,2760,2480,5311,0,512,1546,520,14685
04:13:19.877,1558,2776,2488,5325,0,513,1558,520,14738
04:18:19.880,1562,2788,2498,5339,0,515,1564,520,14786
04:23:19.882,1564,2792,2504,5354,0,515,1564,524,14817
04:28:19.884,1564,2806,2513,5368,0,518,1564,524,14857
04:33:19.886,1576,2808,2514,5372,0,519,1568,524,14881
04:38:19.889,1586,2808,2517,5384,0,520,1576,528,14919
04:43:19.891,1586,2810,2528,5400,0,523,1576,530,14953
04:48:19.925,1588,2816,2530,5414,0,523,1580,532,14983
04:53:19.896,1592,2824,2538,5426,0,524,1582,532,15018
04:58:19.897,1594,2834,2543,5444,0,524,1592,532,15063
05:03:19.900,1598,2850,2554,5458,0,526,1600,532,15118
05:08:19.901,1600,2856,2562,5474,0,527,1600,536,15155
05:13:19.903,1600,2866,2567,5488,0,528,1600,536,15185
05:18:19.904,1608,2872,2571,5496,0,531,1600,536,15214
05:23:19.941,1622,2872,2573,5506,0,531,1612,540,15256
05:28:19.907,1622,2874,2579,5516,0,533,1612,542,15278
05:33:19.942,1624,2880,2586,5534,0,535,1614,544,15317
05:38:19.911,1628,2884,2596,5548,0,536,1616,544,15352
05:43:19.912,1628,2892,2597,5568,0,536,1626,544,15391
05:48:19.914,1634,2910,2608,5578,0,538,1634,544,15446
05:53:19.917,1634,2916,2620,5589,0,539,1636,544,15478
05:58:19.919,1636,2924,2623,5603,0,540,1636,548,15510
06:03:19.920,1638,2936,2629,5619,0,543,1636,548,15549
06:08:19.923,1656,2936,2631,5625,0,543,1646,548,15585
06:13:19.925,1658,2938,2635,5637,0,545,1648,554,15615
06:18:19.927,1660,2940,2644,5655,0,547,1648,554,15648
06:23:19.929,1662,2944,2650,5665,0,548,1652,556,15677
06:28:19.964,1664,2954,2654,5689,0,548,1656,556,15721
06:33:19.932,1670,2974,2662,5695,0,550,1670,556,15777
06:38:19.968,1670,2980,2672,5711,0,551,1672,556,15812
06:43:19.937,1672,2986,2678,5720,0,551,1672,560,15839
06:48:19.939,1672,3000,2687,5740,0,555,1672,560,15886
06:53:19.974,1688,3000,2688,5744,0,555,1678,560,15913
06:58:19.975,1694,3000,2691,5756,0,557,1684,566,15948
07:03:19.945,1694,3004,2702,5774,0,559,1684,566,15983
07:08:19.981,1696,3008,2706,5786,0,560,1688,568,16012
07:13:19.950,1700,3018,2712,5802,0,560,1690,568,16050
07:18:19.986,1700,3030,2719,5818,0,561,1702,568,16098
07:23:19.986,1706,3044,2728,5832,0,563,1708,568,16149
07:28:19.956,1708,3046,2736,5843,0,563,1708,572,16176
07:33:19.992,1708,3062,2743,5861,0,565,1708,572,16219
07:38:19.996,1718,3064,2745,5865,0,567,1710,572,16241
07:43:19.961,1730,3064,2747,5877,0,568,1720,576,16282
07:48:19.963,1730,3066,2760,5891,0,570,1720,578,16315
07:53:19.965,1732,3072,2760,5907,0,571,1724,580,16346
07:58:20.003,1736,3076,2770,5923,0,572,1724,580,16381
08:03:20.002,1736,3090,2773,5940,0,572,1734,580,16425
08:08:19.971,1742,3106,2784,5953,0,574,1744,580,16483
08:13:19.974,1744,3108,2794,5962,0,575,1744,580,16507
08:18:19.976,1744,3120,2799,5976,0,576,1744,584,16543
08:23:19.977,1746,3128,2803,5988,0,579,1744,584,16572
08:28:19.980,1764,3128,2805,5994,0,579,1754,588,16612
08:33:19.982,1766,3130,2813,6006,0,581,1756,590,16642
08:38:19.984,1768,3134,2818,6024,0,583,1758,592,16677
08:43:19.986,1772,3136,2826,6036,0,584,1760,592,16706
08:48:19.988,1772,3150,2829,6060,0,584,1766,592,16753
08:53:19.989,1778,3164,2838,6074,0,586,1778,592,16810
08:58:19.992,1778,3172,2852,6081,0,587,1780,592,16842
09:03:19.994,1780,3178,2854,6095,0,588,1780,596,16871
09:08:19.996,1782,3192,2861,6111,0,591,1780,596,16913
09:13:19.998,1798,3192,2863,6115,0,591,1788,596,16943
09:18:19.999,1802,3192,2865,6129,0,593,1792,602,16975
09:23:20.001,1802,3196,2876,6145,0,595,1792,602,17008
09:28:20.004,1804,3200,2883,6157,0,596,1796,604,17040
09:33:20.005,1808,3210,2886,6177,0,596,1798,604,17079
09:38:20.007,1812,3224,2894,6187,0,597,1814,604,17132
09:43:20.009,1814,3236,2904,6201,0,599,1816,604,17174
09:48:20.012,1816,3242,2910,6212,0,599,1816,608,17203
09:53:20.013,1816,3254,2919,6232,0,602,1816,608,17247
09:58:20.049,1828,3256,2920,6234,0,603,1822,608,17271
10:03:20.019,1838,3256,2923,6250,0,605,1828,614,17314
10:08:20.019,1838,3258,2934,6264,0,607,1828,614,17343
10:13:20.021,1840,3264,2936,6278,0,608,1832,616,17374
10:18:20.023,1844,3272,2944,6294,0,608,1832,616,17410
10:23:20.025,1846,3284,2951,6310,0,608,1846,616,17461
10:28:20.061,1850,3300,2958,6322,0,611,1852,616,17509
10:33:20.029,1852,3300,2968,6333,0,611,1852,620,17536
10:38:20.030,1852,3314,2974,6349,0,613,1852,620,17574
10:43:20.032,1860,3320,2977,6357,0,615,1854,620,17603
10:48:20.034,1874,3320,2979,6367,0,616,1864,624,17644
10:53:20.036,1874,3322,2990,6377,0,618,1864,626,17671
10:58:20.038,1876,3328,2992,6397,0,619,1866,628,17706
11:03:20.039,1878,3332,3001,6411,0,620,1868,628,17738
11:08:20.041,1880,3342,3007,6430,0,620,1876,628,17783
11:13:20.075,1886,3358,3014,6445,0,622,1888,628,17841
11:18:20.044,1888,3364,3024,6454,0,623,1888,628,17869
11:23:20.046,1888,3374,3029,6466,0,625,1888,632,17902
11:28:20.048,1890,3384,3035,6480,0,627,1888,632,17936
11:33:20.049,1908,3384,3037,6486,0,628,1896,636,17975
11:38:20.086,1910,3386,3041,6498,0,630,1900,638,18003
11:43:20.053,1912,3388,3050,6516,0,631,1902,638,18037
11:48:20.054,1914,3392,3057,6526,0,632,1904,640,18065
11:53:20.056,1916,3402,3060,6550,0,632,1910,640,18110
11:58:20.058,1920,3422,3068,6560,0,634,1922,640,18166
12:03:20.059,1922,3428,3080,6573,0,635,1924,640,18202
12:08:20.061,1924,3434,3084,6585,0,636,1924,644,18231
12:13:20.063,1924,3448,3093,6601,0,639,1924,644,18273
12:18:20.064,1942,3448,3095,6605,0,639,1928,644,18301
12:23:20.067,1946,3448,3097,6617,0,641,1936,650,18335
12:28:20.068,1946,3452,3108,6637,0,643,1936,650,18372
12:33:20.070,1948,3456,3114,6647,0,644,1940,652,18401
12:38:20.107,1952,3464,3118,6663,0,644,1942,652,18435
12:43:20.073,1954,3478,3125,6679,0,645,1956,652,18489
12:48:20.075,1958,3492,3134,6693,0,647,1960,652,18536
12:53:20.077,1960,3496,3142,6704,0,647,1960,656,18565
12:58:20.079,1960,3508,3149,6720,0,650,1960,656,18603
13:03:20.081,1972,3512,3152,6726,0,651,1962,656,18631
13:08:20.117,1982,3512,3155,6738,0,653,1972,660,18672
13:13:20.085,1982,3514,3166,6750,0,655,1972,662,18701
13:18:20.087,1984,3520,3170,6766,0,655,1976,664,18735
13:23:20.123,1988,3526,3176,6786,0,656,1976,664,18772
13:28:20.127,1988,3538,3181,6801,0,656,1990,664,18818
13:33:20.093,1994,3554,3192,6814,0,658,1996,664,18872
13:38:20.131,1996,3556,3200,6823,0,659,1996,668,18898
13:43:20.098,1996,3568,3204,6843,0,661,1996,668,18936
13:48:20.099,1998,3576,3209,6849,0,663,1996,668,18959
13:53:20.101,2016,3576,3211,6855,0,663,2006,672,18999
13:58:20.103,2018,3578,3217,6867,0,666,2008,674,19028
14:03:20.139,2020,3584,3224,6885,0,667,2010,676,19066
14:08:20.107,2022,3586,3234,6903,0,668,2012,676,19101
14:13:20.109,2024,3596,3235,6922,0,668,2020,676,19141
14:18:20.112,2030,3612,3246,6931,0,670,2030,676,19195
14:23:20.114,2030,3620,3258,6946,0,671,2032,676,19233
14:28:20.155,2032,3630,3260,6958,0,672,2032,680,19264
14:33:20.156,2034,3640,3267,6972,0,675,2032,680,19300
14:38:20.124,2050,3640,3269,6974,0,675,2040,680,19328
14:43:20.158,2054,3642,3271,6990,0,677,2044,686,19364
14:48:20.128,2054,3644,3282,7008,0,679,2044,686,19397
14:53:20.130,2056,3648,3289,7018,0,680,2048,688,19427
14:58:20.132,2060,3656,3292,7036,0,680,2050,688,19462
15:03:20.133,2062,3676,3300,7050,0,681,2064,688,19521
15:08:20.135,2066,3684,3312,7064,0,683,2068,688,19565
15:13:20.170,2068,3688,3316,7073,0,683,2068,692,19588
15:18:20.139,2068,3704,3325,7093,0,686,2068,692,19636
15:23:20.140,2084,3704,3326,7095,0,687,2074,692,19662
15:28:20.177,2090,3704,3329,7111,0,688,2080,698,19700
15:33:20.145,2090,3708,3340,7117,0,691,2080,698,19724
15:38:20.146,2092,3712,3344,7127,0,691,2084,700,19750
15:43:20.148,2092,3720,3350,7141,0,692,2086,700,19781
15:48:20.150,2092,3730,3357,7155,0,692,2098,700,19824
15:53:20.184,2094,3746,3366,7165,0,694,2104,700,19869
15:58:20.188,2096,3750,3374,7181,0,695,2104,704,19904
16:03:20.155,2096,3764,3380,7197,0,697,2104,704,19942
16:08:20.190,2104,3768,3383,7203,0,699,2106,704,19967
16:13:20.158,2118,3768,3384,7215,0,699,2116,708,20008
16:18:20.160,2118,3770,3394,7233,0,702,2116,710,20043
16:23:20.194,2120,3776,3397,7243,0,703,2120,712,20071
16:28:20.164,2124,3780,3405,7259,0,704,2120,712,20104
16:33:20.166,2124,3790,3406,7278,0,704,2128,712,20142
16:38:20.168,2130,3808,3417,7289,0,706,2138,712,20200
16:43:20.208,2132,3812,3429,7302,0,707,2140,712,20234
16:48:20.207,2132,3822,3433,7314,0,708,2140,716,20265
16:53:20.209,2134,3832,3438,7326,0,711,2140,716,20297
16:58:20.177,2150,3832,3440,7332,0,711,2148,720,20333
17:03:20.179,2154,3834,3446,7346,0,713,2152,722,20367
17:08:20.181,2156,3838,3453,7364,0,715,2154,722,20402
17:13:20.184,2156,3840,3462,7374,0,716,2156,724,20428
17:18:20.222,2160,3854,3464,7396,0,716,2162,724,20476
17:23:20.187,2166,3870,3473,7408,0,718,2174,724,20533
17:28:20.189,2166,3876,3483,7422,0,719,2176,724,20566
17:33:20.226,2168,3882,3489,7433,0,720,2176,728,20596
17:38:20.195,2168,3896,3496,7447,0,723,2176,728,20634
17:43:20.197,2182,3896,3497,7451,0,723,2184,728,20661
17:48:20.199,2190,3898,3500,7467,0,725,2188,734,20702
17:53:20.202,2190,3900,3511,7483,0,727,2188,734,20733
17:58:20.203,2192,3904,3516,7495,0,728,2192,736,20763
18:03:20.206,2196,3912,3521,7511,0,728,2194,736,20798
18:08:20.208,2198,3928,3528,7525,0,729,2208,736,20852
18:13:20.210,2202,3940,3541,7541,0,731,2212,736,20903
18:18:20.212,2204,3944,3545,7550,0,731,2212,740,20926
18:23:20.214,2204,3960,3552,7568,0,734,2212,740,20970
18:28:20.215,2218,3960,3555,7572,0,735,2216,740,20996
18:33:20.251,2226,3960,3558,7586,0,737,2224,746,21037
18:38:20.220,2226,3962,3569,7602,0,739,2224,746,21068
18:43:20.222,2228,3968,3571,7614,0,739,2228,748,21096
18:48:20.224,2232,3976,3579,7630,0,740,2230,748,21135
18:53:20.227,2234,3986,3584,7647,0,740,2240,748,21179
18:58:20.228,2238,4002,3593,7660,0,742,2248,748,21231
19:03:20.231,2240,4006,3603,7671,0,743,2248,748,21259
19:08:20.233,2240,4018,3609,7683,0,744,2248,752,21294
19:13:20.235,2244,4024,3612,7695,0,747,2248,752,21322
19:18:20.274,2262,4024,3614,7705,0,747,2258,756,21366
19:23:20.239,2262,4026,3625,7715,0,749,2260,758,21395
19:28:20.241,2264,4032,3627,7735,0,751,2264,760,21433
19:33:20.243,2266,4038,3637,7749,0,752,2264,760,21466
19:38:20.247,2268,4052,3644,7765,0,752,2274,760,21515
19:43:20.247,2274,4064,3653,7781,0,754,2282,760,21568
19:48:20.250,2274,4068,3661,7795,0,755,2284,764,21601
19:53:20.253,2276,4084,3665,7813,0,756,2284,764,21642
19:58:20.255,2284,4088,3670,7819,0,759,2286,764,21670
20:03:20.257,2296,4088,3672,7831,0,759,2296,768,21710
20:08:20.259,2298,4090,3679,7841,0,761,2296,770,21735
20:13:20.295,2300,4094,3685,7859,0,763,2300,772,21773
20:18:20.263,2304,4098,3693,7875,0,764,2300,772,21806
20:23:20.263,2304,4110,3698,7893,0,764,2308,772,21849
20:28:20.265,2310,4126,3707,7905,0,766,2318,772,21904
20:33:20.266,2310,4132,3719,7918,0,767,2320,776,21942
20:38:20.267,2312,4150,3724,7934,0,768,2320,776,21984
20:43:20.270,2324,4152,3728,7942,0,771,2322,776,22015
20:48:20.271,2334,4152,3732,7950,0,771,2330,780,22049
20:53:20.273,2334,4152,3738,7972,0,773,2332,782,22083
20:58:20.275,2336,4158,3743,7986,0,775,2336,784,22118
21:03:20.276,2340,4162,3753,7996,0,776,2336,784,22147
21:08:20.278,2340,4176,3756,8014,0,776,2350,784,22196
21:13:20.280,2346,4192,3769,8026,0,778,2354,784,22249
21:18:20.281,2346,4196,3777,8042,0,779,2356,784,22280
21:23:20.283,2348,4210,3781,8055,0,781,2356,788,22319
21:28:20.284,2354,4216,3786,8065,0,783,2358,788,22350
21:33:20.287,2366,4216,3788,8075,0,783,2368,792,22388
21:38:20.288,2370,4216,3794,8085,0,786,2368,794,22413
21:43:20.290,2372,4222,3801,8103,0,787,2370,796,22451
21:48:20.292,2376,4226,3808,8115,0,788,2372,796,22481
21:53:20.328,2376,4238,3812,8138,0,788,2380,796,22528
21:58:20.295,2382,4254,3823,8147,0,790,2390,796,22582
22:03:20.298,2382,4260,3831,8162,0,791,2392,796,22614
22:08:20.298,2384,4268,3838,8174,0,792,2392,800,22648
22:13:20.300,2386,4280,3844,8188,0,795,2392,800,22685
22:18:20.302,2402,4280,3846,8192,0,795,2400,804,22719
22:23:20.305,2406,4282,3850,8206,0,797,2404,806,22751
22:28:20.341,2406,4284,3859,8226,0,799,2404,806,22784
22:33:20.343,2408,4288,3866,8234,0,800,2408,808,22812
22:38:20.311,2412,4298,3869,8256,0,800,2410,808,22853
22:43:20.313,2416,4316,3877,8270,0,801,2424,808,22912
22:48:20.315,2418,4324,3889,8280,0,803,2428,808,22950
22:53:20.352,2420,4330,3893,8290,0,803,2428,812,22976
22:58:20.320,2420,4344,3902,8312,0,806,2428,812,23024
23:03:20.322,2436,4344,3904,8312,0,807,2430,812,23045
23:08:20.323,2442,4344,3906,8326,0,809,2440,818,23085
23:13:20.326,2442,4346,3917,8346,0,811,2440,818,23120
23:18:20.329,2444,4352,3919,8356,0,812,2444,820,23147
23:23:20.329,2448,4360,3927,8372,0,812,2446,820,23185
23:28:20.331,2450,4372,3934,8390,0,812,2458,820,23236
23:33:20.332,2454,4386,3945,8402,0,814,2464,820,23285
23:38:20.334,2456,4392,3951,8413,0,815,2464,824,23315
23:43:20.337,2456,4404,3958,8429,0,818,2464,824,23353
23:48:20.338,2466,4408,3960,8435,0,819,2466,824,23378
23:53:20.340,2478,4408,3962,8447,0,820,2476,828,23419
23:58:20.377,2478,4410,3975,8459,0,822,2476,830,23450
00:03:20.343,2480,4416,3975,8477,0,823,2478,832,23481
00:08:20.345,2484,4422,3985,8487,0,824,2480,832,23514
00:13:20.347,2484,4434,3990,8508,0,824,2490,832,23562
00:18:20.348,2490,4446,3997,8523,0,826,2500,832,23614
00:23:20.350,2492,4454,4009,8535,0,827,2500,836,23653
00:28:20.352,2492,4464,4014,8549,0,828,2500,836,23683
00:33:20.353,2498,4472,4018,8559,0,831,2500,836,23714
00:38:20.356,2510,4472,4020,8565,0,831,2510,840,23748
00:43:20.358,2514,4474,4028,8579,0,834,2512,842,23783
00:48:20.360,2514,4478,4033,8595,0,835,2514,842,23811
00:53:20.362,2518,4482,4041,8605,0,836,2516,844,23842
00:58:20.400,2520,4494,4044,8629,0,836,2522,844,23889
01:03:20.401,2526,4510,4053,8639,0,838,2534,844,23944
01:08:20.368,2526,4516,4067,8652,0,839,2536,844,23980
01:13:20.403,2528,4522,4069,8668,0,840,2536,848,24011
01:18:20.374,2528,4536,4076,8682,0,843,2536,848,24049
01:23:20.398,2546,4536,4078,8686,0,843,2544,848,24081
01:28:20.377,2550,4536,4080,8700,0,845,2548,854,24113
01:33:20.380,2550,4540,4091,8716,0,847,2548,854,24146
01:38:20.382,2552,4544,4096,8728,0,848,2552,856,24176
01:43:20.384,2556,4554,4101,8750,0,848,2554,856,24219
01:48:20.385,2560,4570,4108,8760,0,848,2568,856,24270
01:53:20.387,2562,4580,4119,8772,0,851,2572,856,24312
01:58:20.390,2564,4584,4125,8783,0,851,2572,860,24339
02:03:20.393,2564,4598,4132,8803,0,854,2572,860,24383
02:08:20.394,2576,4600,4135,8805,0,855,2576,860,24407
02:13:20.397,2586,4600,4138,8817,0,857,2584,866,24448
02:18:20.399,2586,4602,4149,8837,0,859,2584,866,24483
02:23:20.400,2588,4608,4153,8847,0,860,2588,868,24512
02:28:20.437,2592,4616,4159,8865,0,860,2588,868,24548
02:33:20.406,2594,4628,4164,8880,0,860,2602,868,24596
02:38:20.408,2598,4640,4173,8895,0,863,2608,868,24645
02:43:20.410,2600,4644,4183,8906,0,863,2608,872,24676
02:48:20.447,2600,4658,4188,8922,0,864,2608,872,24712
02:53:20.414,2604,4664,4192,8928,0,867,2610,872,24737
02:58:20.415,2620,4664,4194,8938,0,867,2618,876,24777
03:03:20.418,2622,4666,4201,8952,0,869,2620,878,24808
03:08:20.419,2624,4670,4207,8968,0,871,2624,880,24844
03:13:20.422,2626,4674,4217,8980,0,872,2624,880,24873
03:18:20.456,2628,4686,4222,9000,0,872,2634,880,24922
03:23:20.425,2634,4702,4229,9014,0,874,2642,880,24975
03:28:20.427,2634,4710,4241,9028,0,875,2644,880,25012
03:33:20.430,2636,4718,4244,9042,0,876,2644,884,25044
03:38:20.431,2638,4728,4250,9050,0,879,2644,884,25073
03:43:20.433,2654,4728,4252,9054,0,879,2652,888,25107
03:48:20.436,2658,4730,4256,9070,0,881,2656,890,25141
03:53:20.438,2660,4732,4265,9086,0,883,2656,890,25172
03:58:20.441,2660,4736,4270,9098,0,884,2660,892,25200
04:03:20.443,2664,4746,4275,9118,0,884,2662,892,25241
04:08:20.445,2668,4766,4283,9130,0,886,2678,892,25303
04:13:20.447,2670,4772,4295,9141,0,887,2680,892,25337
04:18:20.449,2672,4778,4297,9151,0,888,2680,896,25362
04:23:20.452,2674,4792,4306,9173,0,891,2680,896,25412
04:28:20.454,2688,4792,4307,9175,0,891,2686,896,25435
04:33:20.456,2694,4792,4310,9185,0,893,2692,902,25468
04:38:20.492,2694,4796,4321,9205,0,895,2692,902,25505
04:43:20.459,2696,4800,4325,9217,0,895,2696,904,25533
04:48:20.496,2700,4808,4331,9231,0,896,2698,904,25568
04:53:20.464,2702,4822,4337,9248,0,896,2710,904,25619
04:58:20.466,2706,4836,4347,9261,0,898,2716,904,25668
05:03:20.467,2708,4840,4355,9274,0,899,2716,908,25700
05:08:20.469,2708,4852,4364,9292,0,901,2716,908,25741
05:13:20.470,2720,4856,4365,9296,0,903,2718,908,25766
05:18:20.472,2730,4856,4368,9308,0,904,2728,912,25806
05:23:20.473,2730,4858,4379,9324,0,906,2728,914,25839
05:28:20.476,2732,4864,4379,9340,0,907,2732,916,25870
05:33:20.478,2736,4872,4389,9348,0,908,2732,916,25901
05:38:20.481,2738,4880,4392,9371,0,908,2744,916,25949
05:43:20.483,2742,4894,4401,9384,0,910,2750,916,25997
05:48:20.486,2744,4900,4413,9397,0,911,2752,916,26033
05:53:20.488,2744,4914,4417,9409,0,912,2752,920,26068
05:58:20.489,2750,4920,4422,9419,0,915,2752,920,26098
06:03:20.492,2764,4920,4424,9425,0,915,2760,924,26132
06:08:20.526,2766,4922,4430,9439,0,917,2764,926,26164
06:13:20.496,2768,4926,4437,9459,0,919,2766,928,26203
06:18:20.497,2770,4928,4446,9467,0,920,2768,928,26227
06:23:20.499,2772,4942,4448,9491,0,920,2776,928,26277
06:28:20.501,2778,4958,4459,9503,0,921,2786,928,26333
06:33:20.504,2778,4964,4469,9512,0,923,2788,928,26362
06:38:20.506,2780,4970,4474,9526,0,923,2788,932,26393
06:43:20.509,2780,4984,4480,9542,0,927,2788,932,26433
06:48:20.511,2798,4984,4482,9548,0,927,2796,932,26467
06:53:20.512,2802,4986,4486,9560,0,929,2800,938,26501
06:58:20.547,2802,4988,4495,9578,0,931,2800,938,26532
07:03:20.553,2804,4992,4501,9588,0,932,2804,940,26561
07:08:20.519,2808,5002,4505,9606,0,932,2806,940,26599
07:13:20.520,2810,5020,4512,9618,0,933,2820,940,26653
07:18:20.554,2814,5028,4523,9634,0,935,2824,940,26698
07:23:20.557,2816,5032,4529,9643,0,935,2824,944,26723
07:28:20.526,2816,5048,4536,9663,0,938,2824,944,26769
07:33:20.528,2830,5048,4539,9665,0,939,2830,944,26795
07:38:20.529,2838,5048,4542,9683,0,941,2836,948,26836
07:43:20.531,2838,5050,4553,9695,0,943,2836,950,26865
07:48:20.532,2840,5056,4557,9709,0,944,2840,952,26898
07:53:20.534,2844,5064,4563,9725,0,944,2842,952,26934
07:58:20.537,2844,5078,4568,9741,0,944,2854,952,26981
08:03:20.573,2850,5090,4579,9753,0,947,2860,952,27031
08:08:20.540,2852,5094,4587,9766,0,947,2860,952,27058
08:13:20.542,2852,5108,4593,9782,0,948,2860,956,27099
08:18:20.544,2858,5112,4596,9788,0,951,2862,956,27123
08:23:20.575,2874,5112,4598,9800,0,951,2872,960,27167
08:28:20.547,2874,5114,4609,9814,0,953,2872,962,27198
08:33:20.549,2876,5120,4611,9828,0,955,2876,964,27230
08:38:20.551,2880,5124,4621,9838,0,956,2876,964,27259
08:43:20.553,2880,5134,4624,9862,0,956,2886,964,27306
08:48:20.555,2886,5150,4633,9874,0,958,2896,964,27361
08:53:20.556,2888,5156,4645,9886,0,959,2896,964,27394
08:58:20.559,2888,5168,4650,9898,0,960,2896,968,27428
09:03:20.562,2890,5176,4654,9912,0,963,2896,968,27459
09:08:20.562,2908,5176,4656,9918,0,963,2906,972,27499
09:13:20.565,2910,5178,4664,9932,0,965,2908,974,27531
09:18:20.566,2912,5182,4669,9948,0,967,2910,974,27562
09:23:20.569,2914,5184,4676,9960,0,968,2912,976,27590
09:28:20.570,2916,5196,4680,9984,0,968,2918,976,27638
09:33:20.572,2920,5212,4689,9992,0,969,2928,976,27686
09:38:20.574,2922,5220,4699,10009,0,971,2932,976,27729
09:43:20.576,2924,5224,4705,10017,0,971,2932,980,27753
09:48:20.577,2926,5240,4712,10033,0,974,2932,980,27797
09:53:20.579,2942,5240,4714,10035,0,974,2938,980,27823
09:58:20.581,2946,5240,4716,10051,0,976,2944,986,27859
10:03:20.583,2946,5244,4727,10069,0,978,2944,986,27894
