Timestamp,ACC (BIRD),ACC (EDYY),ACC (EGGX),ACC (EGTT),ACC (EHAA),ACC (EISN),ACC (EKDK),ACC (ENOS),Total
18:28:19.084,0,0,0,0,0,0,0,0,0
18:33:19.087,0,0,0,0,0,0,0,0,0
18:38:19.090,0,4,0,6,0,0,0,0,10
18:43:19.092,0,10,0,10,0,0,0,0,20
18:48:19.093,2,8,6,6,0,0,4,0,26
18:53:19.095,2,6,6,6,0,0,0,0,20
18:58:19.097,2,10,0,4,0,0,0,4,20
19:03:19.099,16,2,0,12,0,0,4,4,38
19:08:19.101,4,0,4,10,0,0,0,2,20
19:13:19.102,0,8,4,14,0,0,0,2,28
19:18:19.104,4,8,4,6,0,0,0,0,22
19:23:19.107,4,4,5,10,0,0,6,0,29
19:28:19.109,2,2,0,22,0,0,10,0,36
19:33:19.111,0,2,1,24,0,2,4,0,33
19:38:19.112,4,12,15,8,0,0,6,0,45
19:43:19.149,2,14,1,16,0,3,4,4,44
19:48:19.117,18,2,4,8,0,3,6,4,45
19:53:19.119,2,0,5,16,0,1,0,2,26
19:58:19.121,0,10,8,12,0,2,0,2,34
20:03:19.123,4,8,8,8,0,1,0,0,29
20:08:19.125,4,8,3,10,0,0,8,0,33
20:13:19.126,2,4,4,22,0,0,8,0,40
20:18:19.128,0,2,4,22,0,0,2,0,30
20:23:19.130,4,10,13,10,0,2,8,0,47
20:28:19.166,0,12,3,15,0,1,4,4,39
20:33:19.168,20,8,10,8,0,3,6,6,61
20:38:19.135,2,2,7,16,0,3,0,0,30
20:43:19.136,0,10,8,12,0,2,0,2,34
20:48:19.137,4,8,6,8,0,1,0,0,27
20:53:19.173,6,8,3,16,0,0,8,0,41
20:58:19.142,0,4,4,14,0,0,8,0,30
21:03:19.144,0,2,4,25,0,1,4,0,36
21:08:19.146,4,10,15,5,0,1,6,0,41
21:13:19.148,0,14,1,18,0,1,4,4,42
21:18:19.186,18,6,8,9,0,4,6,6,57
21:23:19.153,4,2,7,14,0,2,0,0,29
21:28:19.154,0,8,8,14,0,2,0,2,34
21:33:19.156,4,10,8,8,0,1,0,0,31
21:38:19.159,0,6,3,10,0,0,6,0,25
21:43:19.159,6,4,4,22,0,0,10,0,46
21:48:19.162,0,4,3,21,0,1,2,0,31
21:53:19.164,2,6,12,9,0,1,6,0,36
21:58:19.166,2,14,5,10,0,2,6,4,43
22:03:19.168,12,10,8,13,0,3,4,2,52
22:08:19.204,10,2,5,14,0,2,2,4,39
22:13:19.204,0,4,10,6,0,2,0,2,24
22:18:19.173,4,14,6,18,0,1,0,0,43
22:23:19.176,0,4,5,6,0,0,4,0,19
22:28:19.213,6,4,4,16,0,0,12,0,42
22:33:19.215,0,6,3,22,0,0,0,0,31
22:38:19.182,2,4,6,12,0,2,8,0,34
22:43:19.184,2,8,11,14,0,0,4,4,43
22:48:19.185,4,18,8,11,0,4,4,0,49
22:53:19.223,14,2,5,14,0,2,4,6,47
22:58:19.189,4,0,8,10,0,2,0,2,26
23:03:19.191,2,16,8,16,0,2,0,0,44
23:08:19.193,2,4,4,6,0,0,4,0,20
23:13:19.194,6,6,5,10,0,0,8,0,35
23:18:19.231,0,6,2,22,0,0,4,0,34
23:23:19.199,0,0,3,20,0,2,6,0,31
23:28:19.201,4,12,14,12,0,0,6,0,48
23:33:19.203,2,16,6,11,0,4,4,6,49
23:38:19.205,14,2,8,6,0,2,2,0,34
23:43:19.206,6,2,3,18,0,1,2,6,38
23:48:19.208,2,10,11,14,0,3,0,0,40
23:53:19.211,2,8,6,6,0,0,4,0,26
23:58:19.212,6,8,3,10,0,0,4,0,31
00:03:19.215,0,4,4,20,0,0,8,0,36
00:08:19.216,0,2,2,23,0,2,2,0,31
00:13:19.218,2,12,13,11,0,0,8,0,46
00:18:19.254,2,8,4,12,0,1,4,4,35
00:23:19.222,10,10,9,9,0,5,2,2,47
00:28:19.227,10,2,3,16,0,0,4,6,41
00:33:19.226,4,6,12,14,0,2,0,0,38
00:38:19.262,2,12,4,8,0,2,4,0,32
00:43:19.264,2,8,5,10,0,0,4,0,29
00:48:19.233,4,2,4,16,0,0,8,0,34
00:53:19.235,0,4,4,24,0,0,2,0,34
00:58:19.274,2,6,9,6,0,2,6,0,31
01:03:19.238,2,8,8,14,0,0,4,4,40
01:08:19.239,4,16,9,11,0,5,4,2,51
01:13:19.241,14,2,3,18,0,1,2,2,42
01:18:19.243,6,4,12,6,0,2,2,4,36
01:23:19.245,0,14,4,18,0,2,4,0,42
01:28:19.281,4,4,4,8,0,0,4,0,24
01:33:19.249,4,4,5,10,0,0,4,0,27
01:38:19.287,0,6,3,24,0,0,4,0,37
01:43:19.253,2,2,2,14,0,2,6,0,28
01:48:19.256,2,10,16,14,0,0,6,0,48
01:53:19.257,2,14,7,10,0,4,4,6,47
01:58:19.259,10,6,5,16,0,2,0,2,41
02:03:19.296,10,2,9,8,0,1,4,4,38
02:08:19.263,2,12,7,16,0,3,4,0,44
02:13:19.264,4,4,4,10,0,0,2,0,24
02:18:19.300,4,8,3,8,0,0,4,0,27
02:23:19.268,0,6,4,22,0,1,6,0,39
02:28:19.270,0,0,3,20,0,1,6,0,30
02:33:19.306,4,12,15,8,0,1,4,0,44
02:38:19.274,0,4,5,11,0,1,6,6,33
02:43:19.276,6,14,8,18,0,4,0,2,52
02:48:19.313,12,2,5,6,0,1,4,0,30
02:53:19.313,6,12,7,16,0,2,2,4,49
02:58:19.281,2,6,8,12,0,2,4,0,34
03:03:19.318,6,8,2,8,0,0,2,0,26
03:08:19.285,0,4,4,14,0,0,6,0,28
03:13:19.320,0,2,3,26,0,1,4,0,36
03:18:19.288,2,8,10,10,0,1,8,0,39
03:23:19.323,2,8,9,13,0,1,4,2,39
03:28:19.324,2,10,7,13,0,3,2,6,43
03:33:19.293,14,6,7,12,0,2,2,0,43
03:38:19.327,8,8,6,6,0,0,4,4,36
03:43:19.330,2,10,6,22,0,3,4,0,47
03:48:19.297,2,4,4,8,0,1,2,0,21
03:53:19.333,4,6,5,8,0,0,4,0,27
03:58:19.302,0,4,4,24,0,0,4,0,36
04:03:19.303,2,6,6,14,0,2,8,0,38
04:08:19.343,2,8,11,10,0,0,4,2,37
04:13:19.307,2,6,9,15,0,2,4,6,44
04:18:19.344,4,12,7,14,0,4,0,0,41
04:23:19.311,14,6,6,8,0,0,6,4,44
04:28:19.313,6,12,6,20,0,2,4,0,50
04:33:19.314,0,2,4,8,0,2,2,0,18
04:38:19.317,6,6,5,6,0,0,2,0,25
04:43:19.318,0,6,3,24,0,0,4,0,37
04:48:19.320,0,0,3,16,0,1,8,0,28
04:53:19.356,4,12,10,10,0,1,6,2,45
04:58:19.323,2,6,12,15,0,1,4,4,44
05:03:19.358,2,10,9,12,0,4,0,2,39
05:08:19.361,12,10,3,8,0,1,4,0,38
05:13:19.363,8,12,7,8,0,2,6,4,47
05:18:19.330,2,0,6,20,0,2,2,0,32
05:23:19.332,6,8,2,8,0,0,0,0,24
05:28:19.334,0,4,6,18,0,0,6,0,34
05:33:19.336,0,2,2,21,0,1,6,0,32
05:38:19.338,2,10,7,7,0,1,6,2,35
05:43:19.339,2,8,15,16,0,1,4,0,46
05:48:19.341,4,2,7,13,0,2,2,6,36
05:53:19.343,4,18,5,12,0,3,0,0,42
05:58:19.346,14,10,6,4,0,0,8,4,46
06:03:19.348,4,2,4,22,0,2,4,0,38
06:08:19.349,0,6,4,8,0,2,0,0,20
06:13:19.385,6,2,8,14,0,0,4,0,34
06:18:19.354,0,6,2,16,0,0,4,0,28
06:23:19.355,2,6,3,14,0,1,8,2,36
06:28:19.357,2,10,15,14,0,1,4,0,46
06:33:19.358,2,2,11,13,0,2,4,6,40
06:38:19.361,4,14,5,16,0,3,0,0,42
06:43:19.363,12,14,4,4,0,1,6,0,41
06:48:19.364,8,4,6,18,0,2,6,4,48
06:53:19.366,0,4,4,12,0,2,0,0,22
06:58:19.368,6,4,6,10,0,0,2,0,28
07:03:19.371,0,6,2,20,0,0,2,0,30
07:08:19.373,0,0,3,15,0,1,10,2,31
07:13:19.375,4,12,10,13,0,1,6,0,46
07:18:19.376,2,4,14,13,0,1,4,2,40
07:23:19.411,4,12,9,16,0,2,0,4,47
07:28:19.414,4,18,1,6,0,3,4,0,36
07:33:19.415,12,4,7,14,0,0,8,4,49
07:38:19.384,4,0,6,10,0,2,0,0,22
07:43:19.386,6,6,3,12,0,2,0,0,29
07:48:19.389,0,4,5,16,0,0,4,0,29
07:53:19.391,0,4,3,19,0,1,8,0,35
07:58:19.392,2,8,4,9,0,0,6,2,31
08:03:19.395,2,8,19,16,0,2,4,2,53
08:08:19.396,6,6,9,13,0,1,2,4,41
08:13:19.399,0,24,1,14,0,3,4,0,46
08:18:19.434,14,4,6,6,0,1,6,0,37
08:23:19.403,6,0,6,12,0,2,2,4,32
08:28:19.405,4,6,3,18,0,2,0,0,33
08:33:19.407,2,2,6,8,0,0,4,0,22
08:38:19.409,0,6,3,16,0,1,4,0,30
08:43:19.412,2,2,3,20,0,0,8,2,37
08:48:19.447,2,8,9,14,0,2,4,0,39
08:53:19.416,2,8,19,5,0,0,4,2,40
08:58:19.419,4,14,3,20,0,4,2,4,51
09:03:19.420,2,18,6,6,0,1,4,0,37
09:08:19.422,16,0,2,10,0,1,6,4,39
09:13:19.424,2,4,6,12,0,3,0,0,27
09:18:19.458,4,4,7,18,0,0,2,0,35
09:23:19.464,2,6,2,10,0,0,2,0,22
09:28:19.465,0,2,1,16,0,1,8,2,30
09:33:19.433,4,4,10,18,0,0,8,0,44
09:38:19.436,2,8,12,12,0,2,4,2,42
09:43:19.438,4,12,10,13,0,1,2,0,42
09:48:19.477,0,20,7,12,0,3,4,4,50
09:53:19.442,16,4,1,10,0,1,4,0,36
09:58:19.443,4,2,8,6,0,2,2,4,28
10:03:19.446,4,4,5,22,0,2,0,0,37
10:08:19.447,2,4,3,10,0,0,4,0,23
10:13:19.450,0,4,2,12,0,1,4,2,25
10:18:19.452,2,2,8,21,0,0,8,0,41
10:23:19.454,2,10,10,15,0,2,6,2,47
10:28:19.492,4,10,13,14,0,1,2,0,44
10:33:19.492,2,18,7,12,0,0,4,4,47
10:38:19.460,6,10,2,12,0,4,4,0,38
10:43:19.462,14,0,4,2,0,0,4,4,28
10:48:19.464,0,6,7,24,0,2,0,0,39
10:53:19.465,6,0,5,12,0,2,4,0,29
10:58:19.467,0,6,2,10,0,1,4,2,25
11:03:19.504,2,4,7,14,0,0,4,0,31
11:08:19.471,2,6,5,18,0,1,8,2,42
11:13:19.472,4,14,17,11,0,2,4,0,52
11:18:19.474,2,16,7,14,0,0,4,0,43
11:23:19.477,4,12,4,18,0,3,4,4,49
11:28:19.479,12,0,4,0,0,1,4,0,21
11:33:19.480,4,4,7,16,0,2,0,4,37
11:38:19.515,4,2,4,16,0,2,2,0,30
11:43:19.520,2,6,2,6,0,0,6,2,24
11:48:19.486,0,4,8,24,0,1,2,0,39
11:53:19.489,2,0,5,15,0,0,8,2,32
11:58:19.491,6,14,11,13,0,2,6,0,52
12:03:19.492,2,18,13,11,0,1,4,0,49
12:08:19.494,2,12,2,18,0,1,4,4,43
12:13:19.526,6,4,6,4,0,3,0,0,23
12:18:19.499,12,4,5,10,0,0,4,4,39
12:23:19.501,4,2,3,18,0,2,2,0,31
12:28:19.502,2,4,5,10,0,2,6,2,31
12:33:19.504,0,4,8,16,0,1,0,0,29
12:38:19.539,2,2,5,18,0,0,8,2,37
12:43:19.544,6,10,7,14,0,1,8,0,46
12:48:19.511,0,20,15,7,0,2,4,0,48
12:53:19.514,4,8,4,26,0,0,4,4,50
12:58:19.564,2,10,6,4,0,3,0,0,25
13:03:19.550,12,4,4,10,0,1,4,0,35
13:08:19.520,8,2,3,12,0,2,0,4,31
13:13:19.554,0,2,6,16,0,2,8,0,34
13:18:19.523,2,6,6,16,0,1,0,0,31
13:23:19.547,2,12,14,10,0,0,10,0,48
13:28:19.536,2,10,6,14,0,1,4,4,41
13:33:19.552,18,10,4,10,0,2,6,4,54
13:38:19.590,4,0,3,17,0,0,0,2,26
13:43:19.554,0,8,10,12,0,2,0,2,34
13:48:19.603,4,12,2,8,0,2,0,0,28
13:53:19.587,0,4,7,10,0,1,6,0,28
13:58:19.646,6,2,5,20,0,3,10,0,46
14:03:19.674,0,6,0,22,0,1,2,0,31
14:08:19.622,2,6,16,10,0,1,6,0,41
14:13:19.590,2,16,7,10,0,1,6,4,46
14:18:19.592,14,10,2,13,0,4,4,4,51
14:23:19.649,8,0,7,14,0,2,2,2,35
14:28:19.691,0,4,8,6,0,2,0,0,20
14:33:19.624,4,14,6,18,0,1,0,2,45
14:38:19.693,0,4,5,8,0,0,4,0,21
14:43:19.697,6,6,4,12,0,0,8,0,36
14:48:19.658,0,4,2,24,0,0,4,0,34
14:53:19.657,2,4,7,14,0,2,6,0,35
14:58:19.710,2,8,11,12,0,1,6,4,44
15:03:19.753,8,18,6,11,0,3,4,0,50
15:08:19.684,12,2,7,14,0,3,4,6,48
15:13:19.714,2,0,8,8,0,2,0,0,20
15:18:19.697,0,16,8,18,0,1,0,2,45
15:23:19.740,4,4,4,4,0,0,2,0,18
15:28:19.745,6,6,5,18,0,0,8,0,43
15:33:19.720,0,6,2,18,0,0,6,0,32
15:38:19.751,2,2,3,12,0,2,4,2,27
15:43:19.756,2,4,2,20,0,0,4,0,32
15:48:19.698,2,2,8,17,0,3,4,2,38
15:53:19.776,6,14,12,2,0,3,8,0,45
15:58:19.759,0,18,9,4,0,1,4,0,36
16:03:19.804,4,0,8,22,0,3,4,4,45
16:08:19.814,0,14,8,6,0,0,0,0,28
16:13:19.796,14,6,3,8,0,0,2,0,33
16:18:19.787,8,4,5,12,0,0,4,4,37
16:23:19.793,0,0,5,16,0,1,6,2,30
16:28:19.789,2,4,3,12,0,1,0,0,22
16:33:19.912,2,0,9,18,0,1,6,2,38
16:38:19.820,4,8,6,16,0,1,6,0,41
16:43:19.886,2,22,10,8,0,3,8,0,53
16:48:19.603,4,8,9,21,0,0,4,0,46
16:53:19.606,0,8,7,10,0,2,0,4,31
16:58:19.609,6,8,4,10,0,2,0,0,30
17:03:19.611,16,2,2,6,0,1,4,4,35
17:08:19.613,0,0,6,18,0,3,8,2,37
17:13:19.615,2,8,9,14,0,0,0,0,33
17:18:19.616,2,0,3,14,0,1,4,2,26
17:23:19.619,2,6,8,15,0,1,4,0,36
17:28:19.620,4,20,6,15,0,2,12,0,59
17:33:19.622,2,10,13,15,0,1,4,0,45
17:38:19.624,2,2,6,12,0,1,0,4,27
17:43:19.626,2,16,4,14,0,3,0,0,39
17:48:19.629,12,2,4,6,0,0,2,0,26
17:53:19.630,8,0,3,16,0,2,10,4,43
17:58:19.633,0,2,7,14,0,2,0,2,27
18:03:19.635,2,6,6,10,0,1,4,2,31
18:08:19.637,4,6,8,14,0,0,2,0,34
18:13:19.639,2,14,7,20,0,1,12,0,56
18:18:19.641,4,14,7,12,0,2,6,0,45
18:23:19.643,2,2,10,13,0,0,0,0,27
18:28:19.645,0,14,4,16,0,2,0,4,40
18:33:19.648,8,6,5,6,0,3,2,0,30
18:38:19.649,12,0,2,6,0,0,10,4,34
18:43:19.652,2,2,7,20,0,3,0,2,36
18:48:19.654,2,6,6,12,0,1,4,2,33
18:53:19.656,2,2,10,16,0,1,0,0,31
18:58:19.660,2,16,3,19,0,0,8,0,48
19:03:19.661,6,12,9,15,0,2,12,0,56
19:08:19.662,0,6,12,11,0,1,0,0,30
19:13:19.663,2,8,4,12,0,1,0,4,31
19:18:19.701,2,12,5,12,0,3,0,0,34
19:23:19.668,16,0,2,6,0,0,10,4,38
19:28:19.670,4,2,6,14,0,2,2,2,32
19:33:19.672,0,4,7,24,0,2,2,0,39
19:38:19.674,6,4,9,8,0,1,2,2,32
19:43:19.676,2,16,2,20,0,0,8,0,48
19:48:19.678,4,12,13,12,0,1,10,0,52
19:53:19.680,2,6,8,17,0,2,2,0,37
19:58:19.717,0,10,6,12,0,0,0,4,32
20:03:19.685,6,10,5,10,0,3,2,0,36
20:08:19.723,16,0,1,10,0,1,8,4,40
20:13:19.689,0,2,7,10,0,2,2,2,25
20:18:19.691,2,4,7,20,0,2,2,2,39
20:23:19.693,4,2,5,8,0,1,2,0,22
20:28:19.695,0,14,6,22,0,0,8,0,50
20:33:19.696,6,14,15,16,0,2,10,0,63
20:38:19.731,0,8,6,9,0,1,2,4,30
20:43:19.700,2,14,5,20,0,0,0,0,41
20:48:19.702,8,6,6,8,0,4,0,0,32
20:53:19.704,14,0,2,10,0,0,12,4,42
20:58:19.707,0,2,5,14,0,2,0,2,25
21:03:19.708,2,4,8,16,0,2,4,2,38
21:08:19.711,4,4,8,12,0,1,0,0,29
21:13:19.713,0,10,4,21,0,0,8,0,43
21:18:19.715,6,18,10,9,0,2,10,0,55
21:23:19.751,2,8,12,15,0,1,2,0,40
21:28:19.719,0,8,2,12,0,1,0,4,27
21:33:19.754,2,10,7,14,0,3,0,0,36
21:38:19.723,18,0,2,4,0,0,8,0,32
21:43:19.758,2,0,6,14,0,2,4,6,34
21:48:19.726,2,4,7,20,0,2,2,0,37
21:53:19.728,2,4,7,10,0,1,2,2,28
21:58:19.730,2,10,3,22,0,0,4,0,41
22:03:19.731,4,18,7,10,0,1,14,0,54
22:08:19.734,2,8,13,17,0,2,2,0,44
22:13:19.735,2,6,4,4,0,0,0,4,20
22:18:19.772,2,14,7,22,0,3,0,0,48
22:23:19.740,14,0,4,2,0,1,4,0,25
22:28:19.776,6,0,2,12,0,1,8,6,35
22:33:19.742,0,4,11,20,0,3,0,0,38
22:38:19.743,2,4,4,10,0,1,4,2,27
22:43:19.747,4,8,6,22,0,0,2,0,42
22:48:19.781,2,12,7,10,0,0,14,0,45
22:53:19.783,4,14,9,14,0,3,4,0,48
22:58:19.786,2,6,8,12,0,0,0,4,32
23:03:19.753,0,12,7,18,0,3,0,0,40
23:08:19.755,12,4,3,4,0,1,2,0,26
23:13:19.792,10,0,3,12,0,2,10,4,41
23:18:19.760,0,2,9,20,0,2,0,2,35
23:23:19.763,2,6,4,10,0,0,4,2,28
23:28:19.764,4,6,8,16,0,1,0,0,35
23:33:19.766,0,12,5,16,0,0,12,0,45
23:38:19.769,6,14,7,12,0,2,8,0,49
23:43:19.806,0,4,12,13,0,1,0,0,30
23:48:19.773,2,12,6,16,0,1,0,4,41
23:53:19.775,6,8,3,8,0,3,0,0,28
23:58:19.777,14,0,2,6,0,0,10,4,36
00:03:19.780,2,2,10,14,0,2,2,2,34
00:08:19.781,2,4,3,18,0,2,2,2,33
00:13:19.782,4,4,9,10,0,1,2,0,30
00:18:19.784,0,12,2,22,0,0,8,0,44
00:23:19.786,6,16,11,10,0,2,10,0,55
00:28:19.820,0,6,10,17,0,1,2,0,36
00:33:19.788,2,6,5,13,0,1,0,4,31
00:38:19.790,0,14,6,14,0,3,0,0,37
00:43:19.827,20,0,2,4,0,0,8,0,34
00:48:19.829,2,2,4,14,0,2,4,6,34
00:53:19.797,2,2,9,18,0,2,0,0,33
00:58:19.798,2,4,7,8,0,1,4,2,28
01:03:19.801,2,10,3,22,0,0,2,0,39
01:08:19.801,4,18,8,12,0,2,16,0,60
01:13:19.803,2,8,12,12,0,1,2,0,37
01:18:19.807,2,4,4,11,0,0,0,4,25
01:23:19.807,0,16,9,20,0,3,0,0,48
01:28:19.809,16,0,1,4,0,1,2,0,24
01:33:19.812,6,0,3,10,0,2,10,6,37
01:38:19.814,0,2,11,18,0,3,0,0,34
01:43:19.817,2,6,4,12,0,0,4,2,30
01:48:19.819,4,6,6,16,0,1,2,0,35
01:53:19.820,2,12,7,17,0,0,12,0,50
01:58:19.858,4,16,7,13,0,2,6,0,48
02:03:19.828,2,6,10,12,0,1,0,4,35
02:08:19.862,0,12,7,18,0,2,0,0,39
02:13:19.829,12,4,2,6,0,2,2,0,28
02:18:19.832,10,0,2,12,0,0,10,4,38
02:23:19.834,0,2,13,14,0,2,0,2,33
02:28:19.835,2,6,0,14,0,2,2,2,28
02:33:19.837,4,6,10,16,0,1,2,0,39
02:38:19.839,0,10,5,18,0,0,10,0,43
02:43:19.876,6,12,7,12,0,2,10,0,49
02:48:19.875,0,8,12,11,0,1,0,0,32
02:53:19.843,2,10,4,18,0,1,0,4,39
02:58:19.845,2,10,5,8,0,3,0,0,28
03:03:19.848,18,0,2,10,0,0,10,4,44
03:08:19.850,2,2,6,8,0,2,2,2,24
03:13:19.852,2,4,7,18,0,2,2,0,35
03:18:19.889,4,2,7,10,0,1,2,2,28
03:23:19.856,0,12,3,24,0,0,6,0,45
03:28:19.858,6,18,10,10,0,1,12,0,57
03:33:19.861,0,6,12,17,0,2,2,0,39
03:38:19.863,2,6,2,8,0,0,0,4,22
03:43:19.864,0,14,9,18,0,3,0,0,44
03:48:19.903,18,0,2,4,0,1,4,0,29
03:53:19.903,4,0,2,14,0,2,8,6,36
03:58:19.904,0,4,11,16,0,2,0,0,33
04:03:19.873,2,4,6,10,0,1,4,2,29
04:08:19.875,4,8,4,18,0,0,2,0,36
04:13:19.877,2,16,8,14,0,1,12,0,53
04:18:19.880,4,12,10,14,0,2,6,0,48
04:23:19.882,2,4,6,15,0,0,0,4,31
04:28:19.884,0,14,9,14,0,3,0,0,40
04:33:19.886,12,2,1,4,0,1,4,0,24
04:38:19.889,10,0,3,12,0,1,8,4,38
04:43:19.891,0,2,11,16,0,3,0,2,34
04:48:19.925,2,6,2,14,0,0,4,2,30
04:53:19.896,4,8,8,12,0,1,2,0,35
04:58:19.897,2,10,5,18,0,0,10,0,45
05:03:19.900,4,16,11,14,0,2,8,0,55
05:08:19.901,2,6,8,16,0,1,0,4,37
05:13:19.903,0,10,5,14,0,1,0,0,30
05:18:19.904,8,6,4,8,0,3,0,0,29
05:23:19.941,14,0,2,10,0,0,12,4,42
05:28:19.907,0,2,6,10,0,2,0,2,22
05:33:19.942,2,6,7,18,0,2,2,2,39
05:38:19.911,4,4,10,14,0,1,2,0,35
05:43:19.912,0,8,1,20,0,0,10,0,39
05:48:19.914,6,18,11,10,0,2,8,0,55
05:53:19.917,0,6,12,11,0,1,2,0,32
05:58:19.919,2,8,3,14,0,1,0,4,32
06:03:19.920,2,12,6,16,0,3,0,0,39
06:08:19.923,18,0,2,6,0,0,10,0,36
06:13:19.925,2,2,4,12,0,2,2,6,30
06:18:19.927,2,2,9,18,0,2,0,0,33
06:23:19.929,2,4,6,10,0,1,4,2,29
06:28:19.964,2,10,4,24,0,0,4,0,44
06:33:19.932,6,20,8,6,0,2,14,0,56
06:38:19.968,0,6,10,16,0,1,2,0,35
06:43:19.937,2,6,6,9,0,0,0,4,27
06:48:19.939,0,14,9,20,0,4,0,0,47
06:53:19.974,16,0,1,4,0,0,6,0,27
06:58:19.975,6,0,3,12,0,2,6,6,35
07:03:19.945,0,4,11,18,0,2,0,0,35
07:08:19.981,2,4,4,12,0,1,4,2,29
07:13:19.950,4,10,6,16,0,0,2,0,38
07:18:19.986,0,12,7,16,0,1,12,0,48
07:23:19.986,6,14,9,14,0,2,6,0,51
07:28:19.956,2,2,8,11,0,0,0,4,27
07:33:19.992,0,16,7,18,0,2,0,0,43
07:38:19.996,10,2,2,4,0,2,2,0,22
07:43:19.961,12,0,2,12,0,1,10,4,41
07:48:19.963,0,2,13,14,0,2,0,2,33
07:53:19.965,2,6,0,16,0,1,4,2,31
07:58:20.003,4,4,10,16,0,1,0,0,35
08:03:20.002,0,14,3,17,0,0,10,0,44
08:08:19.971,6,16,11,13,0,2,10,0,58
08:13:19.974,2,2,10,9,0,1,0,0,24
08:18:19.976,0,12,5,14,0,1,0,4,36
08:23:19.977,2,8,4,12,0,3,0,0,29
08:28:19.980,18,0,2,6,0,0,10,4,40
08:33:19.982,2,2,8,12,0,2,2,2,30
08:38:19.984,2,4,5,18,0,2,2,2,35
08:43:19.986,4,2,8,12,0,1,2,0,29
08:48:19.988,0,14,3,24,0,0,6,0,47
08:53:19.989,6,14,9,14,0,2,12,0,57
08:58:19.992,0,8,14,7,0,1,2,0,32
09:03:19.994,2,6,2,14,0,1,0,4,29
09:08:19.996,2,14,7,16,0,3,0,0,42
09:13:19.998,16,0,2,4,0,0,8,0,30
09:18:19.999,4,0,2,14,0,2,4,6,32
09:23:20.001,0,4,11,16,0,2,0,0,33
09:28:20.004,2,4,7,12,0,1,4,2,32
09:33:20.005,4,10,3,20,0,0,2,0,39
09:38:20.007,4,14,8,10,0,1,16,0,53
09:43:20.009,2,12,10,14,0,2,2,0,42
09:48:20.012,2,6,6,11,0,0,0,4,29
09:53:20.013,0,12,9,20,0,3,0,0,44
09:58:20.049,12,2,1,2,0,1,6,0,24
10:03:20.019,10,0,3,16,0,2,6,6,43
10:08:20.019,0,2,11,14,0,2,0,0,29
10:13:20.021,2,6,2,14,0,1,4,2,31
10:18:20.023,4,8,8,16,0,0,0,0,36
10:23:20.025,2,12,7,16,0,0,14,0,51
10:28:20.061,4,16,7,12,0,3,6,0,48
10:33:20.029,2,0,10,11,0,0,0,4,27
10:38:20.030,0,14,6,16,0,2,0,0,38
10:43:20.032,8,6,3,8,0,2,2,0,29
10:48:20.034,14,0,2,10,0,1,10,4,41
10:53:20.036,0,2,11,10,0,2,0,2,27
10:58:20.038,2,6,2,20,0,1,2,2,35
11:03:20.039,2,4,9,14,0,1,2,0,32
11:08:20.041,2,10,6,19,0,0,8,0,45
11:13:20.075,6,16,7,15,0,2,12,0,58
11:18:20.044,2,6,10,9,0,1,0,0,28
11:23:20.046,0,10,5,12,0,2,0,4,33
11:28:20.048,2,10,6,14,0,2,0,0,34
11:33:20.049,18,0,2,6,0,1,8,4,39
11:38:20.086,2,2,4,12,0,2,4,2,28
11:43:20.053,2,2,9,18,0,1,2,0,34
11:48:20.054,2,4,7,10,0,1,2,2,28
11:53:20.056,2,10,3,24,0,0,6,0,45
11:58:20.058,4,20,8,10,0,2,12,0,56
12:03:20.059,2,6,12,13,0,1,2,0,36
12:08:20.061,2,6,4,12,0,1,0,4,29
12:13:20.063,0,14,9,16,0,3,0,0,42
12:18:20.064,18,0,2,4,0,0,4,0,28
12:23:20.067,4,0,2,12,0,2,8,6,34
12:28:20.068,0,4,11,20,0,2,0,0,37
12:33:20.070,2,4,6,10,0,1,4,2,29
12:38:20.107,4,8,4,16,0,0,2,0,34
12:43:20.073,2,14,7,16,0,1,14,0,54
12:48:20.075,4,14,9,14,0,2,4,0,47
12:53:20.077,2,4,8,11,0,0,0,4,29
12:58:20.079,0,12,7,16,0,3,0,0,38
13:03:20.081,12,4,3,6,0,1,2,0,28
13:08:20.117,10,0,3,12,0,2,10,4,41
13:13:20.085,0,2,11,12,0,2,0,2,29
13:18:20.087,2,6,4,16,0,0,4,2,34
13:23:20.123,4,6,6,20,0,1,0,0,37
13:28:20.127,0,12,5,15,0,0,14,0,46
13:33:20.093,6,16,11,13,0,2,6,0,54
13:38:20.131,2,2,8,9,0,1,0,4,26
13:43:20.098,0,12,4,20,0,2,0,0,38
13:48:20.099,2,8,5,6,0,2,0,0,23
13:53:20.101,18,0,2,6,0,0,10,4,40
13:58:20.103,2,2,6,12,0,3,2,2,29
14:03:20.139,2,6,7,18,0,1,2,2,38
14:08:20.107,2,2,10,18,0,1,2,0,35
14:13:20.109,2,10,1,19,0,0,8,0,40
14:18:20.112,6,16,11,9,0,2,10,0,54
14:23:20.114,0,8,12,15,0,1,2,0,38
14:28:20.155,2,10,2,12,0,1,0,4,31
14:33:20.156,2,10,7,14,0,3,0,0,36
14:38:20.124,16,0,2,2,0,0,8,0,28
14:43:20.158,4,2,2,16,0,2,4,6,36
14:48:20.128,0,2,11,18,0,2,0,0,33
14:53:20.130,2,4,7,10,0,1,4,2,30
14:58:20.132,4,8,3,18,0,0,2,0,35
15:03:20.133,2,20,8,14,0,1,14,0,59
15:08:20.135,4,8,12,14,0,2,4,0,44
15:13:20.170,2,4,4,9,0,0,0,4,23
15:18:20.139,0,16,9,20,0,3,0,0,48
15:23:20.140,16,0,1,2,0,1,6,0,26
15:28:20.177,6,0,3,16,0,1,6,6,38
15:33:20.145,0,4,11,6,0,3,0,0,24
15:38:20.146,2,4,4,10,0,0,4,2,26
15:43:20.148,0,8,6,14,0,1,2,0,31
15:48:20.150,0,10,7,14,0,0,12,0,43
15:53:20.184,2,16,9,10,0,2,6,0,45
15:58:20.188,2,4,8,16,0,1,0,4,35
16:03:20.155,0,14,6,16,0,2,0,0,38
16:08:20.190,8,4,3,6,0,2,2,0,25
16:13:20.158,14,0,1,12,0,0,10,4,41
16:18:20.160,0,2,10,18,0,3,0,2,35
16:23:20.194,2,6,3,10,0,1,4,2,28
16:28:20.164,4,4,8,16,0,1,0,0,33
16:33:20.166,0,10,1,19,0,0,8,0,38
16:38:20.168,6,18,11,11,0,2,10,0,58
16:43:20.208,2,4,12,13,0,1,2,0,34
16:48:20.207,0,10,4,12,0,1,0,4,31
16:53:20.209,2,10,5,12,0,3,0,0,32
16:58:20.177,16,0,2,6,0,0,8,4,36
17:03:20.179,4,2,6,14,0,2,4,2,34
17:08:20.181,2,4,7,18,0,2,2,0,35
17:13:20.184,0,2,9,10,0,1,2,2,26
17:18:20.222,4,14,2,22,0,0,6,0,48
17:23:20.187,6,16,9,12,0,2,12,0,57
17:28:20.189,0,6,10,14,0,1,2,0,33
17:33:20.226,2,6,6,11,0,1,0,4,30
17:38:20.195,0,14,7,14,0,3,0,0,38
17:43:20.197,14,0,1,4,0,0,8,0,27
17:48:20.199,8,2,3,16,0,2,4,6,41
17:53:20.202,0,2,11,16,0,2,0,0,31
17:58:20.203,2,4,5,12,0,1,4,2,30
18:03:20.206,4,8,5,16,0,0,2,0,35
18:08:20.208,2,16,7,14,0,1,14,0,54
18:13:20.210,4,12,13,16,0,2,4,0,51
18:18:20.212,2,4,4,9,0,0,0,4,23
18:23:20.214,0,16,7,18,0,3,0,0,44
18:28:20.215,14,0,3,4,0,1,4,0,26
18:33:20.251,8,0,3,14,0,2,8,6,41
18:38:20.220,0,2,11,16,0,2,0,0,31
18:43:20.222,2,6,2,12,0,0,4,2,28
18:48:20.224,4,8,8,16,0,1,2,0,39
18:53:20.227,2,10,5,17,0,0,10,0,44
18:58:20.228,4,16,9,13,0,2,8,0,52
19:03:20.231,2,4,10,11,0,1,0,0,28
19:08:20.233,0,12,6,12,0,1,0,4,35
19:13:20.235,4,6,3,12,0,3,0,0,28
19:18:20.274,18,0,2,10,0,0,10,4,44
19:23:20.239,0,2,11,10,0,2,2,2,29
19:28:20.241,2,6,2,20,0,2,4,2,38
19:33:20.243,2,6,10,14,0,1,0,0,33
19:38:20.247,2,14,7,16,0,0,10,0,49
19:43:20.247,6,12,9,16,0,2,8,0,53
19:48:20.250,0,4,8,14,0,1,2,4,33
19:53:20.253,2,16,4,18,0,1,0,0,41
19:58:20.255,8,4,5,6,0,3,2,0,28
20:03:20.257,12,0,2,12,0,0,10,4,40
20:08:20.259,2,2,7,10,0,2,0,2,25
20:13:20.295,2,4,6,18,0,2,4,2,38
20:18:20.263,4,4,8,16,0,1,0,0,33
20:23:20.263,0,12,5,18,0,0,8,0,43
20:28:20.265,6,16,9,12,0,2,10,0,55
20:33:20.266,0,6,12,13,0,1,2,4,38
20:38:20.267,2,18,5,16,0,1,0,0,42
20:43:20.270,12,2,4,8,0,3,2,0,31
20:48:20.271,10,0,4,8,0,0,8,4,34
20:53:20.273,0,0,6,22,0,2,2,2,34
20:58:20.275,2,6,5,14,0,2,4,2,35
21:03:20.276,4,4,10,10,0,1,0,0,29
21:08:20.278,0,14,3,18,0,0,14,0,49
21:13:20.280,6,16,13,12,0,2,4,0,53
21:18:20.281,0,4,8,16,0,1,2,0,31
21:23:20.283,2,14,4,13,0,2,0,4,39
21:28:20.284,6,6,5,10,0,2,2,0,31
21:33:20.287,12,0,2,10,0,0,10,4,38
21:38:20.288,4,0,6,10,0,3,0,2,25
21:43:20.290,2,6,7,18,0,1,2,2,38
21:48:20.292,4,4,7,12,0,1,2,0,30
21:53:20.328,0,12,4,23,0,0,8,0,47
21:58:20.295,6,16,11,9,0,2,10,0,54
22:03:20.298,0,6,8,15,0,1,2,0,32
22:08:20.298,2,8,7,12,0,1,0,4,34
22:13:20.300,2,12,6,14,0,3,0,0,37
22:18:20.302,16,0,2,4,0,0,8,4,34
22:23:20.305,4,2,4,14,0,2,4,2,32
22:28:20.341,0,2,9,20,0,2,0,0,33
22:33:20.343,2,4,7,8,0,1,4,2,28
22:38:20.311,4,10,3,22,0,0,2,0,41
22:43:20.313,4,18,8,14,0,1,14,0,59
22:48:20.315,2,8,12,10,0,2,4,0,38
22:53:20.352,2,6,4,10,0,0,0,4,26
22:58:20.320,0,14,9,22,0,3,0,0,48
23:03:20.322,16,0,2,0,0,1,2,0,21
23:08:20.323,6,0,2,14,0,2,10,6,40
23:13:20.326,0,2,11,20,0,2,0,0,35
23:18:20.329,2,6,2,10,0,1,4,2,27
23:23:20.329,4,8,8,16,0,0,2,0,38
23:28:20.331,2,12,7,18,0,0,12,0,51
23:33:20.332,4,14,11,12,0,2,6,0,49
23:38:20.334,2,6,6,11,0,1,0,4,30
23:43:20.337,0,12,7,16,0,3,0,0,38
23:48:20.338,10,4,2,6,0,1,2,0,25
23:53:20.340,12,0,2,12,0,1,10,4,41
23:58:20.377,0,2,13,12,0,2,0,2,31
00:03:20.343,2,6,0,18,0,1,2,2,31
00:08:20.345,4,6,10,10,0,1,2,0,33
00:13:20.347,0,12,5,21,0,0,10,0,48
00:18:20.348,6,12,7,15,0,2,10,0,52
00:23:20.350,2,8,12,12,0,1,0,4,39
00:28:20.352,0,10,5,14,0,1,0,0,30
00:33:20.353,6,8,4,10,0,3,0,0,31
00:38:20.356,12,0,2,6,0,0,10,4,34
00:43:20.358,4,2,8,14,0,3,2,2,35
00:48:20.360,0,4,5,16,0,1,2,0,28
00:53:20.362,4,4,8,10,0,1,2,2,31
00:58:20.400,2,12,3,24,0,0,6,0,47
01:03:20.401,6,16,9,10,0,2,12,0,55
01:08:20.368,0,6,14,13,0,1,2,0,36
01:13:20.403,2,6,2,16,0,1,0,4,31
01:18:20.374,0,14,7,14,0,3,0,0,38
01:23:20.398,18,0,2,4,0,0,8,0,32
01:28:20.377,4,0,2,14,0,2,4,6,32
01:33:20.380,0,4,11,16,0,2,0,0,33
01:38:20.382,2,4,5,12,0,1,4,2,30
01:43:20.384,4,10,5,22,0,0,2,0,43
01:48:20.385,4,16,7,10,0,0,14,0,51
01:53:20.387,2,10,11,12,0,3,4,0,42
01:58:20.390,2,4,6,11,0,0,0,4,27
02:03:20.393,0,14,7,20,0,3,0,0,44
02:08:20.394,12,2,3,2,0,1,4,0,24
02:13:20.397,10,0,3,12,0,2,8,6,41
02:18:20.399,0,2,11,20,0,2,0,0,35
02:23:20.400,2,6,4,10,0,1,4,2,29
02:28:20.437,4,8,6,18,0,0,0,0,36
02:33:20.406,2,12,5,15,0,0,14,0,48
02:38:20.408,4,12,9,15,0,3,6,0,49
02:43:20.410,2,4,10,11,0,0,0,4,31
02:48:20.447,0,14,5,16,0,1,0,0,36
02:53:20.414,4,6,4,6,0,3,2,0,25
02:58:20.415,16,0,2,10,0,0,8,4,40
03:03:20.418,2,2,7,14,0,2,2,2,31
03:08:20.419,2,4,6,16,0,2,4,2,36
03:13:20.422,2,4,10,12,0,1,0,0,29
03:18:20.456,2,12,5,20,0,0,10,0,49
03:23:20.425,6,16,7,14,0,2,8,0,53
03:28:20.427,0,8,12,14,0,1,2,0,37
03:33:20.430,2,8,3,14,0,1,0,4,32
03:38:20.431,2,10,6,8,0,3,0,0,29
03:43:20.433,16,0,2,4,0,0,8,4,34
03:48:20.436,4,2,4,16,0,2,4,2,34
03:53:20.438,2,2,9,16,0,2,0,0,31
03:58:20.441,0,4,5,12,0,1,4,2,28
04:03:20.443,4,10,5,20,0,0,2,0,41
04:08:20.445,4,20,8,12,0,2,16,0,62
04:13:20.447,2,6,12,11,0,1,2,0,34
04:18:20.449,2,6,2,10,0,1,0,4,25
04:23:20.452,2,14,9,22,0,3,0,0,50
04:28:20.454,14,0,1,2,0,0,6,0,23
04:33:20.456,6,0,3,10,0,2,6,6,33
04:38:20.492,0,4,11,20,0,2,0,0,37
04:43:20.459,2,4,4,12,0,0,4,2,28
04:48:20.496,4,8,6,14,0,1,2,0,35
04:53:20.464,2,14,6,17,0,0,12,0,51
04:58:20.466,4,14,10,13,0,2,6,0,49
05:03:20.467,2,4,8,13,0,1,0,4,32
05:08:20.469,0,12,9,18,0,2,0,0,41
05:13:20.470,12,4,1,4,0,2,2,0,25
05:18:20.472,10,0,3,12,0,1,10,4,40
05:23:20.473,0,2,11,16,0,2,0,2,33
05:28:20.476,2,6,0,16,0,1,4,2,31
05:33:20.478,4,8,10,8,0,1,0,0,31
05:38:20.481,2,8,3,23,0,0,12,0,48
05:43:20.483,4,14,9,13,0,2,6,0,48
05:48:20.486,2,6,12,13,0,1,2,0,36
05:53:20.488,0,14,4,12,0,1,0,4,35
05:58:20.489,6,6,5,10,0,3,0,0,30
06:03:20.492,14,0,2,6,0,0,8,4,34
06:08:20.526,2,2,6,14,0,2,4,2,32
06:13:20.496,2,4,7,20,0,2,2,2,39
06:18:20.497,2,2,9,8,0,1,2,0,24
06:23:20.499,2,14,2,24,0,0,8,0,50
06:28:20.501,6,16,11,12,0,1,10,0,56
06:33:20.504,0,6,10,9,0,2,2,0,29
06:38:20.506,2,6,5,14,0,0,0,4,31
06:43:20.509,0,14,6,16,0,4,0,0,40
06:48:20.511,18,0,2,6,0,0,8,0,34
06:53:20.512,4,2,4,12,0,2,4,6,34
06:58:20.547,0,2,9,18,0,2,0,0,31
07:03:20.553,2,4,6,10,0,1,4,2,29
07:08:20.519,4,10,4,18,0,0,2,0,38
07:13:20.520,2,18,7,12,0,1,14,0,54
07:18:20.554,4,8,11,16,0,2,4,0,45
07:23:20.557,2,4,6,9,0,0,0,4,25
07:28:20.526,0,16,7,20,0,3,0,0,46
07:33:20.528,14,0,3,2,0,1,6,0,26
07:38:20.529,8,0,3,18,0,2,6,4,41
07:43:20.531,0,2,11,12,0,2,0,2,29
07:48:20.532,2,6,4,14,0,1,4,2,33
07:53:20.534,4,8,6,16,0,0,2,0,36
07:58:20.537,0,14,5,16,0,0,12,0,47
08:03:20.573,6,12,11,12,0,3,6,0,50
08:08:20.540,2,4,8,13,0,0,0,0,27
08:13:20.542,0,14,6,16,0,1,0,4,41
08:18:20.544,6,4,3,6,0,3,2,0,24
08:23:20.575,16,0,2,12,0,0,10,4,44
08:28:20.547,0,2,11,14,0,2,0,2,31
08:33:20.549,2,6,2,14,0,2,4,2,32
08:38:20.551,4,4,10,10,0,1,0,0,29
08:43:20.553,0,10,3,24,0,0,10,0,47
08:48:20.555,6,16,9,12,0,2,10,0,55
08:53:20.556,2,6,12,12,0,1,0,0,33
08:58:20.559,0,12,5,12,0,1,0,4,34
09:03:20.562,2,8,4,14,0,3,0,0,31
09:08:20.562,18,0,2,6,0,0,10,4,40
09:13:20.565,2,2,8,14,0,2,2,2,32
09:18:20.566,2,4,5,16,0,2,2,0,31
09:23:20.569,2,2,7,12,0,1,2,2,28
09:28:20.570,2,12,4,24,0,0,6,0,48
09:33:20.572,4,16,9,8,0,1,10,0,48
09:38:20.574,2,8,10,17,0,2,4,0,43
09:43:20.576,2,4,6,8,0,0,0,4,24
09:48:20.577,2,16,7,16,0,3,0,0,44
09:53:20.579,16,0,2,2,0,0,6,0,26
09:58:20.581,4,0,2,16,0,2,6,6,36
10:03:20.583,0,4,11,18,0,2,0,0,35
